[BDCFF]
Version=0.5
[game]
Name=Boulder Dash 2- the expert levels
Author=Dustin Bachstein, Peter Liepa with Chris Gray
Date=2008
WWW=http://www.boulder-dash.com/
Levels=5

[cave]
Name=Cave A. Intro
Intermission=false
IntermissionProperties.instantlife=true
IntermissionProperties.rewardlife=false
Charset=Original
Fontset=Original, BD2
Size=40 22 0 0 39 21
Colors=Black Black Orange Gray1 White White Orange
DiamondsRequired=20 25 25 25 25
DiamondValue=15 15
CaveTime=100 95 90 90 90
TimeValue=5 6 7 8 9
CaveScheduling=bd2
FrameTime=200 200 200 200 200
CaveDelay=6 6 6 6 6
RandSeed=15 28 24 25 19
RandomFill=BOULDER 50 DIAMOND 5 DIRT 0 DIRT 0
ActiveGuyIsFirst=false
AmoebaProperties.immediately=false
MagicWallTime=25 25 25 25 25
MagicWallProperties.convertamoeba=false
SlimePermeabilityC64=0 0 0 0 0
BorderProperties.lineshift=true
BorderProperties.objectwraparound=true

[objects]
Line=19 1 19 11 WALL
Line=1 11 19 11 WALL
Line=3 6 16 6 DIRT
Line=3 7 16 7 MAGICWALL
Line=3 10 16 10 DIRT
Line=33 1 33 16 STEELWALL
Point=20 5 BOULDER
FillRect=21 1 32 16 DIRT
Line=33 16 14 16 STEELWALL
FillRect=15 17 38 20 SPACE
Raster=16 17 4 1 6 1 FIREFLYr
Raster=18 17 4 4 6 1 DIRT
Raster=22 1 6 3 2 2 MAGICWALL
Raster=23 1 3 3 4 2 MAGICWALL
Raster=22 2 3 1 4 1 MAGICWALL
Point=28 4 MAGICWALL
Point=32 4 MAGICWALL
Point=22 4 MAGICWALL
Line=23 5 24 5 DIRT
Point=37 3 INBOX
Point=5 18 OUTBOX
[/objects]
[/cave]

[cave]
Name=Cave B. Silos
Selectable=false
Intermission=false
IntermissionProperties.instantlife=true
IntermissionProperties.rewardlife=false
Charset=Original
Fontset=Original, BD2
Size=40 22 0 0 39 21
Colors=Black Black Green Purple White White Green
DiamondsRequired=95 96 97 98 99
DiamondValue=3 10
CaveTime=160 160 160 160 160
TimeValue=5 6 7 8 9
CaveScheduling=bd2
FrameTime=200 200 200 200 200
CaveDelay=6 6 6 6 6
RandSeed=51 67 55 59 69
RandomFill=BOULDER 254 AMOEBA 127 DIRT 0 DIRT 0
ActiveGuyIsFirst=false
AmoebaProperties.immediately=false
AmoebaTime=25 25 25 25 25
MagicWallProperties.convertamoeba=false
SlimePermeabilityC64=0 0 0 0 0
BorderProperties.lineshift=true
BorderProperties.objectwraparound=true

[objects]
Line=1 15 30 15 STEELWALL
FillRect=1 16 38 20 SPACE
FillRect=1 0 7 15 STEELWALL
FillRect=11 0 17 15 STEELWALL
FillRect=21 0 27 15 STEELWALL
FillRect=31 0 38 15 STEELWALL
Raster=9 14 3 1 10 1 BOULDER
Raster=9 15 3 1 10 1 DIRT
Line=1 1 38 1 BOULDER
Line=1 2 38 2 DIRT
Line=1 3 38 3 DIRT
Rectangle=2 1 3 15 SPACE
Rectangle=36 1 37 15 SPACE
Point=3 16 INBOX
Point=38 16 OUTBOX
[/objects]
[/cave]

[cave]
Name=Cave C. Spiral
Selectable=false
Intermission=false
IntermissionProperties.instantlife=true
IntermissionProperties.rewardlife=false
Charset=Original
Fontset=Original, BD2
Size=40 22 0 0 39 21
Colors=Black Black Purple Orange White White Purple
DiamondsRequired=15 19 21 13 20
DiamondValue=25 50
CaveTime=200 150 150 150 150
TimeValue=5 6 7 8 9
CaveScheduling=bd2
FrameTime=200 200 200 200 200
CaveDelay=6 6 6 6 6
RandSeed=40 168 11 125 113
RandomFill=SPACE 120 BOULDER 50 FIREFLYl 15 DIAMOND 9
ActiveGuyIsFirst=false
AmoebaProperties.immediately=false
MagicWallProperties.convertamoeba=false
SlimePermeabilityC64=0 0 0 0 0
BorderProperties.lineshift=true
BorderProperties.objectwraparound=true

[objects]
Line=7 4 38 4 STEELWALL
Line=7 4 7 15 STEELWALL
Line=7 16 32 16 STEELWALL
Line=32 16 32 9 STEELWALL
Line=14 8 32 8 STEELWALL
Line=14 8 14 12 STEELWALL
Line=14 12 25 12 STEELWALL
Point=37 3 INBOX
Point=18 10 OUTBOX
[/objects]
[/cave]

[cave]
Name=Cave D. Breakthrough
Selectable=false
Intermission=false
IntermissionProperties.instantlife=true
IntermissionProperties.rewardlife=false
Charset=Original
Fontset=Original, BD2
Size=40 22 0 0 39 21
Colors=Black Black Green Orange White White Green
DiamondsRequired=58 60 62 63 64
DiamondValue=5 8
CaveTime=40 40 40 40 40
TimeValue=5 6 7 8 9
CaveScheduling=bd2
FrameTime=200 200 200 200 200
CaveDelay=6 6 6 6 6
ActiveGuyIsFirst=false
AmoebaProperties.immediately=false
AmoebaTime=140 140 140 140 140
MagicWallProperties.convertamoeba=false
SlimePermeabilityC64=0 0 0 0 0
BorderProperties.lineshift=true
BorderProperties.objectwraparound=true

[objects]
Line=5 2 14 2 FIREFLYl
Point=15 2 BOULDER
Line=5 5 14 5 FIREFLYl
Point=15 5 BOULDER
Line=5 8 14 8 FIREFLYl
Point=15 8 BOULDER
Rectangle=22 1 23 20 AMOEBA
Line=21 10 21 20 WALL
FillRect=24 1 38 20 DIAMOND DIRT
Rectangle=18 10 20 12 DIRT
Point=19 11 INBOX
Point=1 10 OUTBOX
[/objects]
[/cave]

[cave]
Name=Intermission 1
Selectable=false
Intermission=true
IntermissionProperties.instantlife=true
IntermissionProperties.rewardlife=false
Charset=Original
Fontset=Original, BD2
Size=40 22 0 0 19 11
Colors=Black Black LightBlue Red White White LightBlue
DiamondsRequired=1 1 1 1 1
DiamondValue=30 0
CaveTime=20 20 20 20 20
TimeValue=5 6 7 8 9
CaveScheduling=bd2
PALTiming=true
FrameTime=200 200 200 200 200
CaveDelay=6 6 6 6 6
ActiveGuyIsFirst=false
AmoebaProperties.immediately=false
MagicWallProperties.convertamoeba=false
SlimePermeabilityC64=0 0 0 0 0
BorderProperties.lineshift=true
BorderProperties.objectwraparound=true

[objects]
FillRect=19 0 39 21 STEELWALL
FillRect=0 11 39 21 STEELWALL
FillRect=5 2 11 8 BOULDER FIREFLYl
Point=8 5 DIAMOND
Point=3 3 INBOX
Point=2 10 OUTBOX
[/objects]
[/cave]

[cave]
Name=Cave E. Shower
Intermission=false
IntermissionProperties.instantlife=true
IntermissionProperties.rewardlife=false
Charset=Original
Fontset=Original, BD2
Size=40 22 0 0 39 21
Colors=Black Black Blue Gray2 White White Blue
DiamondsRequired=10 12 14 16 18
DiamondValue=20 40
CaveTime=30 30 30 30 30
TimeValue=5 6 7 8 9
CaveScheduling=bd2
FrameTime=200 200 200 200 200
CaveDelay=6 6 6 6 6
RandSeed=34 38 39 35 36
RandomFill=BOULDER 255 DIAMOND 127 DIRT 0 DIRT 0
ActiveGuyIsFirst=false
AmoebaProperties.immediately=false
MagicWallTime=2 2 2 2 2
MagicWallProperties.convertamoeba=false
SlimePermeabilityC64=224 224 224 224 224
BorderProperties.lineshift=true
BorderProperties.objectwraparound=true

[objects]
FillRect=1 7 38 20 SPACE
FillRect=20 1 38 20 DIRT
Raster=1 5 19 3 1 2 SLIME
Line=1 18 19 18 SLIME
Line=1 20 19 20 MAGICWALL
Point=3 17 INBOX
Point=35 18 OUTBOX
[/objects]
[/cave]

[cave]
Name=Cave F. Gauntlet
Selectable=false
Intermission=false
IntermissionProperties.instantlife=true
IntermissionProperties.rewardlife=false
Charset=Original
Fontset=Original, BD2
Size=40 22 0 0 39 21
Colors=Black Black Brown LightRed White White Brown
DiamondsRequired=42 34 42 40 38
DiamondValue=5 80
CaveTime=200 180 180 180 180
TimeValue=5 6 7 8 9
CaveScheduling=bd2
FrameTime=200 200 200 200 200
CaveDelay=6 6 6 6 6
RandSeed=14 15 16 17 19
RandomFill=BOULDER 220 DIAMOND 80 DIRT 0 DIRT 0
ActiveGuyIsFirst=false
AmoebaProperties.immediately=false
MagicWallProperties.convertamoeba=false
SlimePermeabilityC64=0 0 0 0 0
BorderProperties.lineshift=true
BorderProperties.objectwraparound=true

[objects]
Rectangle=1 1 38 20 DIRT
FillRect=1 10 38 12 DIRT WALL
FillRect=1 1 15 20 DIRT
FillRect=25 1 38 20 DIRT
Line=14 2 14 19 WALL
Line=26 2 26 19 WALL
Point=1 2 INBOX
Point=2 5 OUTBOX
FillRect=4 1 8 20 SPACE
Line=3 2 3 20 STEELWALL
Line=9 1 9 19 STEELWALL
Raster=5 3 3 6 1 3 STEELWALL
Raster=6 2 1 3 1 6 FIREFLYl
Raster=6 7 1 3 1 6 FIREFLYr
[/objects]
[/cave]

[cave]
Name=Cave G. Jail
Selectable=false
Intermission=false
IntermissionProperties.instantlife=true
IntermissionProperties.rewardlife=false
Charset=Original
Fontset=Original, BD2
Size=40 22 0 0 39 21
Colors=Black Black LightRed Purple White White LightRed
DiamondsRequired=12 13 13 12 15
DiamondValue=20 50
CaveTime=150 140 130 120 120
TimeValue=5 6 7 8 9
CaveScheduling=bd2
FrameTime=200 200 200 200 200
CaveDelay=6 6 6 6 6
RandSeed=14 230 3 197 124
RandomFill=SPACE 120 BOULDER 50 FIREFLYl 15 DIAMOND 9
ActiveGuyIsFirst=false
AmoebaProperties.immediately=false
MagicWallProperties.convertamoeba=false
SlimePermeabilityC64=0 0 0 0 0
BorderProperties.lineshift=true
BorderProperties.objectwraparound=true

[objects]
Raster=2 2 9 5 4 4 WALL
Raster=3 2 9 5 4 4 WALL
Add=0 1 FIREFLYl BOULDER
FillRect=11 4 23 13 WALL SPACE
Line=11 5 25 5 BOULDER
Line=11 6 25 6 DIRT
Raster=11 5 5 8 3 1 WALL
Rectangle=0 0 39 21 STEELWALL
Point=9 11 INBOX
Point=12 11 OUTBOX
[/objects]
[/cave]

[cave]
Name=Cave H. Ring Around The Rosy
Selectable=false
Intermission=false
IntermissionProperties.instantlife=true
IntermissionProperties.rewardlife=false
Charset=Original
Fontset=Original, BD2
Size=40 22 0 0 39 21
Colors=Black Black Green Brown Cyan Cyan Green
DiamondsRequired=70 75 80 82 85
DiamondValue=5 10
CaveTime=80 80 80 80 80
TimeValue=5 6 7 8 9
CaveScheduling=bd2
FrameTime=200 200 200 200 200
CaveDelay=6 6 6 6 6
ActiveGuyIsFirst=false
AmoebaProperties.immediately=false
AmoebaTime=120 120 120 120 120
MagicWallProperties.convertamoeba=false
SlimePermeabilityC64=0 0 0 0 0
BorderProperties.lineshift=true
BorderProperties.objectwraparound=true

[objects]
Rectangle=2 2 13 9 SPACE
Raster=4 9 5 1 2 1 BUTTERFLYl
Raster=13 2 1 4 1 2 BUTTERFLYd
Raster=3 2 5 1 2 1 BUTTERFLYr
Line=20 1 20 15 WALL
Line=25 1 34 1 AMOEBA
Point=1 1 INBOX
Point=19 4 OUTBOX
[/objects]
[/cave]

[cave]
Name=Intermission 2
Selectable=false
Intermission=true
IntermissionProperties.instantlife=true
IntermissionProperties.rewardlife=false
Charset=Original
Fontset=Original, BD2
Size=40 22 0 0 19 11
Colors=Black Black Blue Gray3 White White Blue
DiamondsRequired=6 6 6 6 6
DiamondValue=10 0
CaveTime=20 20 20 20 20
TimeValue=5 6 7 8 9
CaveScheduling=bd2
PALTiming=true
FrameTime=200 200 200 200 200
CaveDelay=6 6 6 6 6
ActiveGuyIsFirst=false
AmoebaProperties.immediately=false
MagicWallProperties.convertamoeba=false
SlimePermeabilityC64=0 0 0 0 0
BorderProperties.lineshift=true
BorderProperties.objectwraparound=true

[objects]
FillRect=19 0 39 21 STEELWALL
FillRect=0 11 39 21 STEELWALL
FillRect=3 3 5 5 SPACE DIAMOND
FillRect=8 3 10 5 SPACE DIAMOND
FillRect=13 3 15 5 SPACE DIAMOND
FillRect=3 7 5 9 SPACE DIAMOND
FillRect=8 7 10 9 SPACE DIAMOND
FillRect=13 7 15 9 SPACE DIAMOND
Raster=5 3 3 1 5 1 FIREFLYl
Raster=3 7 3 1 5 1 BUTTERFLYl
Point=1 2 INBOX
Point=18 10 OUTBOX
[/objects]
[/cave]

[cave]
Name=Cave I. Fast Tricks
Intermission=false
IntermissionProperties.instantlife=true
IntermissionProperties.rewardlife=false
Charset=Original
Fontset=Original, BD2
Size=40 22 0 0 39 21
Colors=Black Black Gray1 Orange White White Gray1
DiamondsRequired=75 75 75 75 75
DiamondValue=5 50
CaveTime=80 75 70 65 60
TimeValue=5 6 7 8 9
CaveScheduling=bd2
FrameTime=200 200 200 200 200
CaveDelay=6 6 6 6 6
ActiveGuyIsFirst=false
AmoebaProperties.immediately=false
MagicWallProperties.convertamoeba=false
SlimePermeabilityC64=0 0 0 0 0
BorderProperties.lineshift=true
BorderProperties.objectwraparound=true

[objects]
FillRect=1 1 38 20 SPACE
Raster=3 2 17 5 2 4 DIAMOND
Raster=4 2 17 5 2 4 DIRT
Raster=3 3 34 5 1 4 STEELWALL
Rectangle=12 1 13 8 SPACE
Rectangle=28 1 29 8 SPACE
Raster=4 1 1 5 1 4 FIREFLYl
Raster=20 1 1 5 1 4 FIREFLYl
Raster=36 1 1 5 1 4 FIREFLYl
FillRect=17 9 22 20 SPACE
Line=19 10 19 19 STEELWALL
Raster=20 10 1 5 1 2 DIAMOND
Raster=20 11 1 5 1 2 DIRT
Point=19 9 FIREFLYl
Point=1 13 INBOX
Point=38 13 OUTBOX
[/objects]
[/cave]

[cave]
Name=Cave J. Mixed Doubles
Selectable=false
Intermission=false
IntermissionProperties.instantlife=true
IntermissionProperties.rewardlife=false
Charset=Original
Fontset=Original, BD2
Size=40 22 0 0 39 21
Colors=Black Black Blue Orange White White Blue
DiamondsRequired=54 63 72 72 72
DiamondValue=5 10
CaveTime=120 120 120 100 80
TimeValue=5 6 7 8 9
CaveScheduling=bd2
FrameTime=200 200 200 200 200
CaveDelay=6 6 6 6 6
RandSeed=5 6 8 9 10
RandomFill=BOULDER 1 DIRT 0 DIRT 0 DIRT 0
ActiveGuyIsFirst=false
AmoebaProperties.immediately=false
MagicWallProperties.convertamoeba=false
SlimePermeabilityC64=0 0 0 0 0
BorderProperties.lineshift=true
BorderProperties.objectwraparound=true

[objects]
Raster=3 3 4 2 7 9 FIREFLYl
Raster=4 3 4 2 7 9 BUTTERFLYd
Raster=3 4 4 2 7 9 BOULDER
Raster=4 4 4 2 7 9 BOULDER
Point=7 10 INBOX
Point=30 15 OUTBOX
[/objects]
[/cave]

[cave]
Name=Cave K. Snake
Selectable=false
Intermission=false
IntermissionProperties.instantlife=true
IntermissionProperties.rewardlife=false
Charset=Original
Fontset=Original, BD2
Size=40 22 0 0 39 21
Colors=Black Black Orange LightBlue White White Orange
DiamondsRequired=27 26 29 31 33
DiamondValue=15 30
CaveTime=60 60 60 60 60
TimeValue=5 6 7 8 9
CaveScheduling=bd2
FrameTime=200 200 200 200 200
CaveDelay=6 6 6 6 6
RandSeed=15 18 19 36 73
RandomFill=DIAMOND 15 DIRT 0 DIRT 0 DIRT 0
ActiveGuyIsFirst=false
AmoebaProperties.immediately=false
MagicWallTime=2 2 2 2 2
MagicWallProperties.convertamoeba=false
SlimePermeabilityC64=0 0 0 0 0
BorderProperties.lineshift=true
BorderProperties.objectwraparound=true

[objects]
Rectangle=1 1 38 20 DIRT
Line=1 1 25 1 FIREFLYl
Line=1 2 38 2 DIRT
Point=10 2 BOULDER
FillRect=9 3 11 5 WALL SPACE
Line=9 3 11 3 DIRT
Add=0 1 DIAMOND MAGICWALL
Point=10 3 INBOX
Point=35 18 OUTBOX
[/objects]
[/cave]

[cave]
Name=Cave L. Gridlock
Selectable=false
Intermission=false
IntermissionProperties.instantlife=true
IntermissionProperties.rewardlife=false
Charset=Original
Fontset=Original, BD2
Size=40 22 0 0 39 21
Colors=Black Black Brown LightRed White White Brown
DiamondsRequired=34 32 26 34 42
DiamondValue=15 0
CaveTime=150 150 150 150 150
TimeValue=5 6 7 8 9
CaveScheduling=bd2
FrameTime=200 200 200 200 200
CaveDelay=6 6 6 6 6
RandSeed=11 15 45 36 32
RandomFill=BOULDER 90 DIAMOND 20 DIRT 0 DIRT 0
ActiveGuyIsFirst=false
AmoebaProperties.immediately=false
MagicWallProperties.convertamoeba=false
SlimePermeabilityC64=0 0 0 0 0
BorderProperties.lineshift=true
BorderProperties.objectwraparound=true

[objects]
Raster=1 6 36 3 1 6 WALL
Raster=6 1 6 18 6 1 WALL
Raster=3 6 6 3 6 6 SPACE
Raster=6 3 6 3 6 6 SPACE
Line=38 1 38 20 DIRT
Line=1 20 38 20 DIRT
Point=21 3 INBOX
Point=37 6 OUTBOX
[/objects]
[/cave]

[cave]
Name=Intermission 3
Selectable=false
Intermission=true
IntermissionProperties.instantlife=true
IntermissionProperties.rewardlife=false
Charset=Original
Fontset=Original, BD2
Size=40 22 0 0 19 11
Colors=Black Black Blue Orange White White Blue
DiamondsRequired=2 2 2 2 2
DiamondValue=25 60
CaveTime=20 20 20 20 20
TimeValue=5 6 7 8 9
CaveScheduling=bd2
FrameTime=200 200 200 200 200
CaveDelay=6 6 6 6 6
InitialFill=SPACE
ActiveGuyIsFirst=false
AmoebaProperties.immediately=false
MagicWallProperties.convertamoeba=false
SlimePermeabilityC64=0 0 0 0 0
BorderProperties.lineshift=true
BorderProperties.objectwraparound=true

[objects]
FillRect=19 0 39 21 STEELWALL
FillRect=0 11 39 21 STEELWALL
Line=3 1 11 9 FIREFLYl
Line=13 7 17 3 FIREFLYl
Raster=2 1 9 10 2 1 DIRT
Point=14 5 DIAMOND
Point=16 5 DIAMOND
Point=1 2 INBOX
Point=18 5 OUTBOX
[/objects]
[/cave]

[cave]
Name=Cave M. Combination
Intermission=false
IntermissionProperties.instantlife=true
IntermissionProperties.rewardlife=false
Charset=Original
Fontset=Original, BD2
Size=40 22 0 0 39 21
Colors=Black Black Blue LightRed White White Blue
DiamondsRequired=50 70 80 85 90
DiamondValue=2 10
CaveTime=180 180 200 250 250
TimeValue=5 6 7 8 9
CaveScheduling=bd2
FrameTime=200 200 200 200 200
CaveDelay=6 6 6 6 6
RandSeed=51 14 35 18 12
RandomFill=BOULDER 255 DIAMOND 127 DIRT 0 DIRT 0
ActiveGuyIsFirst=false
AmoebaProperties.immediately=false
MagicWallProperties.convertamoeba=false
SlimePermeabilityC64=0 0 0 0 0
BorderProperties.lineshift=true
BorderProperties.objectwraparound=true

[objects]
FillRect=1 16 38 20 BOULDER
Raster=2 1 19 9 2 2 STEELWALL
Raster=2 2 19 9 2 2 DIRT
Line=1 18 38 18 SLIME
Rectangle=1 19 38 20 DIRT
Rectangle=37 1 38 20 DIRT
Point=2 19 INBOX
Point=2 13 OUTBOX
[/objects]
[/cave]

[cave]
Name=Cave N. Tree
Selectable=false
Intermission=false
IntermissionProperties.instantlife=true
IntermissionProperties.rewardlife=false
Charset=Original
Fontset=Original, BD2
Size=40 22 0 0 39 21
Colors=Black Black Brown Orange White White Brown
DiamondsRequired=21 21 21 21 21
DiamondValue=20 1
CaveTime=120 100 80 60 40
TimeValue=5 6 7 8 9
CaveScheduling=bd2
FrameTime=200 200 200 200 200
CaveDelay=6 6 6 6 6
RandSeed=19 14 13 12 11
RandomFill=BOULDER 60 DIRT 0 DIRT 0 DIRT 0
ActiveGuyIsFirst=false
AmoebaProperties.immediately=false
MagicWallProperties.convertamoeba=false
SlimePermeabilityC64=0 0 0 0 0
BorderProperties.lineshift=true
BorderProperties.objectwraparound=true

[objects]
Rectangle=1 1 38 20 SPACE
Rectangle=2 2 37 13 DIRT
FillRect=1 14 38 20 SPACE
Raster=1 19 9 1 2 1 FIREFLYl
Raster=1 20 19 1 2 1 FIREFLYl
FillRect=19 14 21 20 DIRT SPACE
Raster=5 2 7 3 5 4 DIAMOND
Point=20 17 INBOX
Point=20 19 OUTBOX
[/objects]
[/cave]

[cave]
Name=Cave O. Cocoons
Selectable=false
Intermission=false
IntermissionProperties.instantlife=true
IntermissionProperties.rewardlife=false
Charset=Original
Fontset=Original, BD2
Size=40 22 0 0 39 21
Colors=Black Black LightBlue LightRed White White LightBlue
DiamondsRequired=36 36 36 36 37
DiamondValue=10 10
CaveTime=120 100 80 60 120
TimeValue=5 6 7 8 9
CaveScheduling=bd2
FrameTime=200 200 200 200 200
CaveDelay=6 6 6 6 6
ActiveGuyIsFirst=false
AmoebaProperties.immediately=false
MagicWallTime=10 10 10 10 10
MagicWallProperties.convertamoeba=false
SlimePermeabilityC64=0 0 0 0 0
BorderProperties.lineshift=true
BorderProperties.objectwraparound=true

[objects]
FillRect=3 6 9 12 DIRT SPACE
Point=4 8 BUTTERFLYd
Point=6 5 BOULDER
FillRect=12 6 18 15 WALL DIRT
Line=12 16 18 16 WALL
FillRect=13 7 17 11 SPACE
Line=13 6 17 6 DIRT
Raster=12 6 4 1 2 1 HEXPANDINGWALL
Point=13 8 BUTTERFLYd
Point=15 7 DIRT
Point=15 6 BOULDER
FillRect=19 8 28 16 SPACE
FillRect=21 9 27 15 DIRT SPACE
Line=20 9 27 9 WALL
Point=22 11 BUTTERFLYd
Point=24 1 BOULDER
Point=24 3 BOULDER
FillRect=30 6 36 12 DIRT SPACE
Point=31 8 BUTTERFLYd
Point=30 7 BOULDER
Line=30 12 36 12 MAGICWALL
Line=30 13 36 13 MAGICWALL
Point=3 18 INBOX
Point=38 3 OUTBOX
[/objects]
[/cave]

[cave]
Name=Cave P. Spelunking
Selectable=false
Intermission=false
IntermissionProperties.instantlife=true
IntermissionProperties.rewardlife=false
Charset=Original
Fontset=Original, BD2
Size=40 22 0 0 39 21
Colors=Black Black Brown LightRed White White Brown
DiamondsRequired=20 28 34 26 30
DiamondValue=10 40
CaveTime=200 200 200 240 240
TimeValue=5 6 7 8 9
CaveScheduling=bd2
FrameTime=200 200 200 200 200
CaveDelay=6 6 6 6 6
RandSeed=14 15 16 17 18
RandomFill=SPACE 189 BOULDER 179 DIAMOND 19 DIRT 0
ActiveGuyIsFirst=false
AmoebaProperties.immediately=false
MagicWallProperties.convertamoeba=false
SlimePermeabilityC64=0 0 0 0 0
BorderProperties.lineshift=true
BorderProperties.objectwraparound=true

[objects]
Rectangle=1 1 38 20 DIRT
Point=3 2 INBOX
Point=20 11 OUTBOX
[/objects]
[/cave]

[cave]
Name=Intermission 4
Selectable=false
Intermission=true
IntermissionProperties.instantlife=true
IntermissionProperties.rewardlife=false
Charset=Original
Fontset=Original, BD2
Size=40 22 0 0 19 11
Colors=Black Black Blue Orange White White Blue
DiamondsRequired=1 1 1 1 1
DiamondValue=10 20
CaveTime=20 20 20 20 20
TimeValue=5 6 7 8 9
CaveScheduling=bd2
FrameTime=200 200 200 200 200
CaveDelay=6 6 6 6 6
ActiveGuyIsFirst=false
AmoebaProperties.immediately=false
MagicWallProperties.convertamoeba=false
SlimePermeabilityC64=0 0 0 0 0
BorderProperties.lineshift=true
BorderProperties.objectwraparound=true

[objects]
FillRect=19 0 39 21 STEELWALL
FillRect=0 11 39 21 STEELWALL
FillRect=6 5 8 7 SPACE BOULDER
FillRect=10 2 12 4 SPACE DIAMOND
Point=12 2 FIREFLYl
Point=2 1 INBOX
FillRect=10 8 12 10 FIREFLYl OUTBOX
Line=12 8 12 10 STEELWALL
[/objects]
[/cave]
[/game]
[/BDCFF]