[BDCFF]
Version=0.5
[game]
Name=Boulder Dash- the expert levels!
Author=Dustin Bachstein,Peter Liepa with Chris Gray
Date=2008
WWW=http://www.boulder-dash.com/
Difficulty=hard to very hard
Levels=5

[cave]
Name=Cave A. Intro
Intermission=false
IntermissionProperties.instantlife=true
IntermissionProperties.rewardlife=false
Charset=Original
Fontset=Original
Story=Hi BD fans!!\n\nI have made this game for those who still like the original Boulder Dash game made by Peter Liepa. This is a new challenge for those who have managed to play through the highest level of Boulder Dash 1 and want a new challenge! I have made four more difficulty levels in which I changed only random seeds, needed diamonds and cave time- the same properties in which the original difficulty levels varied. \nI think some of the levels are very hard now, so I've saved replays from every cave on every difficulty level that show the solutions.\n\nFor comparison, I have added the highest level (5) of the original BD game; it is the first level of this game. Levels 2-5 of this game are my own ones.\n\nHave fun!\n\nGreetings Dustin
Size=40 22 0 0 39 21
Colors=Black Black Orange Gray1 White White Orange
DiamondsRequired=12 15 18 21 24
DiamondValue=10 15
CaveTime=30 30 30 30 30
TimeValue=5 6 7 8 9
CaveScheduling=bd1
FrameTime=200 200 200 200 200
CaveDelay=0 0 0 0 0
RandSeed=14 16 19 20 23
RandomFill=SPACE 60 BOULDER 50 DIAMOND 9 DIRT 0
ActiveGuyIsFirst=false
SlimePermeabilityC64=0 0 0 0 0
BorderProperties.lineshift=true
BorderProperties.objectwraparound=true

[objects]
Line=1 7 30 7 WALL
Line=9 14 38 14 WALL
Point=3 2 INBOX
Point=38 16 OUTBOX
[/objects]
[/cave]

[cave]
Name=Cave B. Rooms
Intermission=false
IntermissionProperties.instantlife=true
IntermissionProperties.rewardlife=false
Charset=Original
Fontset=Original
Size=40 22 0 0 39 21
Colors=Black Black LightRed Purple White White LightRed
DiamondsRequired=10 11 11 14 11
DiamondValue=20 50
CaveTime=70 70 80 80 120
TimeValue=5 6 7 8 9
CaveScheduling=bd1
FrameTime=200 200 200 200 200
CaveDelay=0 0 0 0 0
RandSeed=88 96 220 123 13
RandomFill=SPACE 60 BOULDER 50 DIAMOND 9 FIREFLYl 2
ActiveGuyIsFirst=false
SlimePermeabilityC64=0 0 0 0 0
BorderProperties.lineshift=true
BorderProperties.objectwraparound=true

[objects]
Line=1 6 38 6 WALL
Line=1 13 38 13 WALL
Line=8 1 8 20 WALL
Line=16 1 16 20 WALL
Line=24 1 24 20 WALL
Line=32 1 32 20 WALL
Line=1 3 38 3 SPACE
Line=1 9 38 9 SPACE
Line=1 16 38 16 SPACE
Line=20 1 20 20 SPACE
Point=18 19 INBOX
Point=18 20 OUTBOX
[/objects]
[/cave]

[cave]
Name=Cave C. Maze
Intermission=false
Charset=Original
Fontset=Original
Size=40 22 0 0 39 21
Colors=Black Black Brown Orange White White Brown
DiamondsRequired=21 21 20 22 17
DiamondValue=15 0
CaveTime=70 70 80 80 80
TimeValue=5 6 7 8 9
CaveScheduling=bd1
FrameTime=200 200 200 200 200
CaveDelay=0 0 0 0 0
RandSeed=55 247 108 78 80
RandomFill=WALL 100 BOULDER 50 DIAMOND 9 DIRT 0
SlimePermeabilityC64=0 0 0 0 0

[objects]
Point=3 2 INBOX
Point=39 18 OUTBOX
[/objects]
[/cave]

[cave]
Name=Cave D. Butterflies
Intermission=false
IntermissionProperties.instantlife=true
IntermissionProperties.rewardlife=false
Charset=Original
Fontset=Original
Size=40 22 0 0 39 21
Colors=Black Black Purple Orange White White Purple
DiamondsRequired=36 36 36 36 36
DiamondValue=5 20
CaveTime=50 45 40 35 30
TimeValue=5 6 7 8 9
CaveScheduling=bd1
FrameTime=200 200 200 200 200
CaveDelay=0 0 0 0 0
RandSeed=119 124 130 137 145
RandomFill=BOULDER 20 DIRT 0 DIRT 0 DIRT 0
ActiveGuyIsFirst=false
SlimePermeabilityC64=0 0 0 0 0
BorderProperties.lineshift=true
BorderProperties.objectwraparound=true

[objects]
Point=1 1 INBOX
Point=38 20 OUTBOX
FillRect=8 8 11 11 DIRT SPACE
Point=10 9 BUTTERFLYl
FillRect=16 8 19 11 DIRT SPACE
Point=18 9 BUTTERFLYl
FillRect=24 8 27 11 DIRT SPACE
Point=26 9 BUTTERFLYl
FillRect=32 8 35 11 DIRT SPACE
Point=34 9 BUTTERFLYl
[/objects]
[/cave]

[cave]
Name=Intermission 1
Intermission=true
IntermissionProperties.instantlife=true
IntermissionProperties.rewardlife=false
Charset=Original
Fontset=Original
Size=40 22 0 0 19 11
Colors=Black Black LightBlue Red White White LightBlue
DiamondsRequired=6 6 6 6 6
DiamondValue=30 0
CaveTime=10 10 10 10 10
TimeValue=5 6 7 8 9
CaveScheduling=bd1
FrameTime=200 200 200 200 200
CaveDelay=0 0 0 0 0
InitialFill=SPACE
ActiveGuyIsFirst=false
SlimePermeabilityC64=0 0 0 0 0
BorderProperties.lineshift=true
BorderProperties.objectwraparound=true

[objects]
FillRect=19 0 39 21 STEELWALL
FillRect=0 11 39 21 STEELWALL
Point=10 10 BUTTERFLYr
Point=10 2 BOULDER
Point=10 3 DIRT
Point=3 3 INBOX
Point=18 10 OUTBOX
[/objects]
[/cave]

[cave]
Name=Cave E. Guards
Intermission=false
IntermissionProperties.instantlife=true
IntermissionProperties.rewardlife=false
Charset=Original
Fontset=Original
Size=40 22 0 0 39 21
Colors=Black Black Brown LightRed White White Brown
DiamondsRequired=8 8 8 8 8
DiamondValue=50 90
CaveTime=30 27 24 21 18
TimeValue=5 6 7 8 9
CaveScheduling=bd1
FrameTime=200 200 200 200 200
CaveDelay=0 0 0 0 0
ActiveGuyIsFirst=false
SlimePermeabilityC64=0 0 0 0 0
BorderProperties.lineshift=true
BorderProperties.objectwraparound=true

[objects]
Point=1 1 INBOX
Point=39 20 OUTBOX
FillRect=8 8 10 10 SPACE
FillRect=16 8 18 10 SPACE
FillRect=24 8 26 10 SPACE
FillRect=32 8 34 10 SPACE
Point=9 10 DIAMOND
Point=10 8 FIREFLYl
Point=17 10 DIAMOND
Point=18 8 FIREFLYl
Point=25 10 DIAMOND
Point=26 8 FIREFLYl
Point=33 10 DIAMOND
Point=34 8 FIREFLYl
FillRect=8 14 10 16 SPACE
FillRect=16 14 18 16 SPACE
FillRect=24 14 26 16 SPACE
FillRect=32 14 34 16 SPACE
Point=9 16 DIAMOND
Point=10 14 FIREFLYl
Point=17 16 DIAMOND
Point=18 14 FIREFLYl
Point=25 16 DIAMOND
Point=26 14 FIREFLYl
Point=33 16 DIAMOND
Point=34 14 FIREFLYl
[/objects]
[/cave]

[cave]
Name=Cave F. Firefly dens
Intermission=false
IntermissionProperties.instantlife=true
IntermissionProperties.rewardlife=false
Charset=Original
Fontset=Original
Size=40 22 0 0 39 21
Colors=Black Black LightBlue LightRed White White LightBlue
DiamondsRequired=8 8 8 8 8
DiamondValue=40 60
CaveTime=80 70 60 50 50
TimeValue=5 6 7 8 9
CaveScheduling=bd1
FrameTime=200 200 200 200 200
CaveDelay=0 0 0 0 0
RandSeed=23 24 25 26 15
RandomFill=BOULDER 50 DIRT 0 DIRT 0 DIRT 0
ActiveGuyIsFirst=false
SlimePermeabilityC64=0 0 0 0 0
BorderProperties.lineshift=true
BorderProperties.objectwraparound=true

[objects]
FillRect=1 1 10 4 WALL SPACE
FillRect=1 4 10 7 WALL SPACE
FillRect=1 7 10 10 WALL SPACE
FillRect=1 10 10 13 WALL SPACE
Line=10 1 10 13 DIRT
Point=3 3 DIAMOND
Point=4 3 FIREFLYl
Point=3 6 DIAMOND
Point=4 6 FIREFLYl
Point=3 9 DIAMOND
Point=4 9 FIREFLYl
Point=3 12 DIAMOND
Point=4 12 FIREFLYl
FillRect=29 1 38 4 WALL SPACE
FillRect=29 4 38 7 WALL SPACE
FillRect=29 7 38 10 WALL SPACE
FillRect=29 10 38 13 WALL SPACE
Line=29 1 29 13 DIRT
Point=36 3 DIAMOND
Point=35 3 FIREFLYl
Point=36 6 DIAMOND
Point=35 6 FIREFLYl
Point=36 9 DIAMOND
Point=35 9 FIREFLYl
Point=36 12 DIAMOND
Point=35 12 FIREFLYl
Point=3 18 INBOX
Point=38 18 OUTBOX
[/objects]
[/cave]

[cave]
Name=Cave G. Amoeba
Intermission=false
IntermissionProperties.instantlife=true
IntermissionProperties.rewardlife=false
Charset=Original
Fontset=Original
Size=40 22 0 0 39 21
Colors=Black Black Brown LightRed Green Green Brown
DiamondsRequired=25 30 40 60 90
DiamondValue=10 20
CaveTime=120 120 120 135 150
TimeValue=5 6 7 8 9
CaveScheduling=bd1
FrameTime=200 200 200 200 200
CaveDelay=0 0 0 0 0
RandSeed=9 24 14 16 18
RandomFill=SPACE 100 BOULDER 40 FIREFLYl 2 DIRT 0
ActiveGuyIsFirst=false
AmoebaProperties.waitforhatching=true
AmoebaTime=75 75 75 75 75
SlimePermeabilityC64=0 0 0 0 0
BorderProperties.lineshift=true
BorderProperties.objectwraparound=true

[objects]
Line=1 5 12 5 WALL
Line=28 3 38 3 WALL
Line=19 19 20 19 AMOEBA
Point=4 4 DIAMOND
Point=4 12 DIAMOND
Point=4 20 DIAMOND
Point=34 2 DIAMOND
Point=34 10 DIAMOND
Point=34 20 DIAMOND
Point=20 1 INBOX
Point=39 5 OUTBOX
[/objects]
[/cave]

[cave]
Name=Cave H. Enchanted wall
Intermission=false
IntermissionProperties.instantlife=true
IntermissionProperties.rewardlife=false
Charset=Original
Fontset=Original
Size=40 22 0 0 39 21
Colors=Black Black Red LightBlue White White Red
DiamondsRequired=20 25 30 35 40
DiamondValue=10 20
CaveTime=80 100 120 160 200
TimeValue=5 6 7 8 9
CaveScheduling=bd1
FrameTime=200 200 200 200 200
CaveDelay=0 0 0 0 0
RandSeed=6 11 13 17 15
RandomFill=SPACE 90 BOULDER 50 FIREFLYl 2 DIRT 0
ActiveGuyIsFirst=false
MagicWallTime=20 20 20 20 20
SlimePermeabilityC64=0 0 0 0 0
BorderProperties.lineshift=true
BorderProperties.objectwraparound=true

[objects]
Point=4 4 DIAMOND
Point=34 2 DIAMOND
Point=34 10 DIAMOND
Point=0 3 OUTBOX
Point=20 1 INBOX
Line=1 5 12 5 WALL
Line=1 13 12 13 WALL
Line=28 3 38 3 WALL
Line=28 11 38 11 WALL
Line=14 15 21 15 MAGICWALL
Point=12 14 DIAMOND
Point=14 16 SPACE
Point=19 16 DIAMOND
Line=14 13 21 13 DIRT
[/objects]
[/cave]

[cave]
Name=Intermission 2
Intermission=true
IntermissionProperties.instantlife=true
IntermissionProperties.rewardlife=false
Charset=Original
Fontset=Original
Size=40 22 0 0 19 11
Colors=Black Black Blue Gray3 White White Blue
DiamondsRequired=16 16 16 16 16
DiamondValue=10 0
CaveTime=15 15 15 15 15
TimeValue=5 6 7 8 9
CaveScheduling=bd1
FrameTime=200 200 200 200 200
CaveDelay=0 0 0 0 0
ActiveGuyIsFirst=false
SlimePermeabilityC64=0 0 0 0 0
BorderProperties.lineshift=true
BorderProperties.objectwraparound=true

[objects]
FillRect=19 0 39 21 STEELWALL
FillRect=0 11 39 21 STEELWALL
Line=1 1 9 9 BOULDER
Line=2 1 9 8 FIREFLYl
Line=1 3 8 10 DIAMOND
Line=1 4 7 10 BOULDER
Line=18 1 10 9 BOULDER
Line=18 3 11 10 DIAMOND
Line=18 4 12 10 BOULDER
Point=1 2 INBOX
Point=18 2 OUTBOX
[/objects]
[/cave]

[cave]
Name=Cave I. Greed
Intermission=false
Charset=Original
Fontset=Original
Size=40 22 0 0 39 21
Colors=Black Black Orange Purple White White Orange
DiamondsRequired=90 95 99 99 99
DiamondValue=5 10
CaveTime=120 120 120 130 130
TimeValue=5 6 7 8 9
CaveScheduling=bd1
FrameTime=200 200 200 200 200
CaveDelay=0 0 0 0 0
RandSeed=51 30 14 26 13
RandomFill=BOULDER 240 DIAMOND 120 DIRT 0 DIRT 0
SlimePermeabilityC64=0 0 0 0 0

[objects]
FillRect=5 8 17 20 WALL SPACE
Point=12 8 DIRT
FillRect=25 8 37 20 WALL SPACE
Point=31 8 DIRT
Line=17 16 25 16 WALL
Line=17 17 25 17 SPACE
Point=7 10 INBOX
Point=8 10 OUTBOX
[/objects]
[/cave]

[cave]
Name=Cave J. Tracks
Intermission=false
Charset=Original
Fontset=Original
Size=40 22 0 0 39 21
Colors=Black Black Blue Orange White White Blue
DiamondsRequired=12 14 14 14 16
DiamondValue=25 60
CaveTime=100 100 90 80 80
TimeValue=5 6 7 8 9
CaveScheduling=bd1
FrameTime=200 200 200 200 200
CaveDelay=0 0 0 0 0
SlimePermeabilityC64=0 0 0 0 0

[objects]
Point=13 1 INBOX
Point=39 20 OUTBOX
Line=5 2 21 18 DIAMOND
Line=21 2 5 18 DIAMOND
FillRect=5 9 21 11 SPACE FIREFLYl
Rectangle=1 2 21 18 WALL
Point=13 2 SPACE
Rectangle=7 4 19 16 WALL
Point=13 4 SPACE
Rectangle=9 6 17 14 WALL
Point=13 6 SPACE
Rectangle=11 8 15 12 WALL
Point=13 8 SPACE
FillRect=3 4 5 18 WALL FIREFLYl
Point=4 4 SPACE
Line=4 14 4 17 DIAMOND
[/objects]
[/cave]

[cave]
Name=Cave K. Crowd
Intermission=false
IntermissionProperties.instantlife=true
IntermissionProperties.rewardlife=false
Charset=Original
Fontset=Original
Size=40 22 0 0 39 21
Colors=Black Black Gray1 Orange White White Gray1
DiamondsRequired=6 6 6 6 6
DiamondValue=50 0
CaveTime=240 240 240 240 240
TimeValue=6 7 8 9 10
CaveScheduling=bd1
FrameTime=200 200 200 200 200
CaveDelay=0 0 0 0 0
RandSeed=100 124 130 46 198
RandomFill=SPACE 100 BOULDER 80 FIREFLYl 2 DIRT 0
ActiveGuyIsFirst=false
SlimePermeabilityC64=0 0 0 0 0
BorderProperties.lineshift=true
BorderProperties.objectwraparound=true

[objects]
Line=10 1 10 9 WALL
Line=20 1 20 9 WALL
Line=30 1 30 9 WALL
Line=9 20 9 12 WALL
Line=12 13 28 13 WALL
Line=5 9 13 9 WALL
Line=15 9 23 9 WALL
Line=25 9 33 9 WALL
Line=28 17 38 7 WALL
Point=4 1 DIAMOND
Point=14 1 DIAMOND
Point=24 1 DIAMOND
Point=34 1 DIAMOND
Point=4 20 DIAMOND
Point=35 19 DIAMOND
Point=20 18 INBOX
Point=38 15 OUTBOX
[/objects]
[/cave]

[cave]
Name=Cave L. Walls
Intermission=false
Charset=Original
Fontset=Original
Size=40 22 0 0 39 21
Colors=Black Black Gray2 LightRed White White Gray2
DiamondsRequired=21 19 22 15 16
DiamondValue=20 0
CaveTime=160 160 180 180 180
TimeValue=5 6 7 8 9
CaveScheduling=bd1
FrameTime=200 200 200 200 200
CaveDelay=0 0 0 0 0
RandSeed=102 83 118 240 43
RandomFill=SPACE 60 BOULDER 50 DIAMOND 9 DIRT 0
SlimePermeabilityC64=0 0 0 0 0

[objects]
Line=10 3 10 20 WALL
Line=14 3 14 20 WALL
Line=18 3 18 20 WALL
Line=22 3 22 20 WALL
Line=2 4 12 4 WALL
Line=2 8 12 8 WALL
Line=2 12 16 12 WALL
Line=2 16 12 16 WALL
FillRect=30 2 33 5 DIRT SPACE
Point=32 3 FIREFLYl
FillRect=30 7 33 10 DIRT SPACE
Point=32 8 FIREFLYl
FillRect=30 12 33 15 DIRT SPACE
Point=32 13 FIREFLYl
Point=3 18 INBOX
Point=39 20 OUTBOX
[/objects]
[/cave]

[cave]
Name=Intermission 3
Intermission=true
IntermissionProperties.instantlife=true
IntermissionProperties.rewardlife=false
Charset=Original
Fontset=Original
Remark=Hatching a bit earlier than usual, to make it solvable.
Size=40 22 0 0 19 11
Colors=Black Black Blue Orange White White Blue
DiamondsRequired=14 14 14 14 14
DiamondValue=10 0
CaveTime=20 20 20 20 20
TimeValue=5 6 7 8 9
CaveScheduling=ms
FrameTime=70 70 70 70 70
CaveDelay=0 0 0 0 0
InitialFill=SPACE
ActiveGuyIsFirst=false
SlimePermeabilityC64=0 0 0 0 0
BorderProperties.lineshift=true
BorderProperties.objectwraparound=true

[objects]
FillRect=19 0 39 21 STEELWALL
FillRect=0 11 39 21 STEELWALL
Line=1 10 18 10 DIAMOND
FillRect=15 7 18 10 FIREFLYl
Point=8 1 INBOX
Point=18 5 OUTBOX
[/objects]
[/cave]

[cave]
Name=Cave M. Apocalypse
Intermission=false
IntermissionProperties.instantlife=true
IntermissionProperties.rewardlife=false
Charset=Original
Fontset=Original
Size=40 22 0 0 39 21
Colors=Black Black Blue Orange Green Green Blue
DiamondsRequired=80 90 99 99 99
DiamondValue=5 8
CaveTime=140 140 140 140 140
TimeValue=5 6 7 8 9
CaveScheduling=bd1
FrameTime=200 200 200 200 200
CaveDelay=0 0 0 0 0
RandSeed=4 5 7 6 47
RandomFill=BOULDER 40 DIRT 0 DIRT 0 DIRT 0
ActiveGuyIsFirst=false
AmoebaTime=140 140 140 140 140
SlimePermeabilityC64=0 0 0 0 0
BorderProperties.lineshift=true
BorderProperties.objectwraparound=true

[objects]
Point=18 1 INBOX
Point=10 1 OUTBOX
Point=20 1 AMOEBA
Line=5 16 34 16 WALL
Line=5 17 34 17 BUTTERFLYl
Line=5 18 34 18 BOULDER
Rectangle=5 19 34 20 DIRT
[/objects]
[/cave]

[cave]
Name=Cave N. Zigzag
Intermission=false
IntermissionProperties.instantlife=true
IntermissionProperties.rewardlife=false
Charset=Original
Fontset=Original
Size=40 22 0 0 39 21
Colors=Black Black Gray2 Orange White White Gray2
DiamondsRequired=45 48 51 54 54
DiamondValue=10 20
CaveTime=130 130 130 130 90
TimeValue=5 6 7 8 9
CaveScheduling=bd1
FrameTime=200 200 200 200 200
CaveDelay=0 0 0 0 0
ActiveGuyIsFirst=false
SlimePermeabilityC64=0 0 0 0 0
BorderProperties.lineshift=true
BorderProperties.objectwraparound=true

[objects]
FillRect=10 8 22 20 DIRT SPACE
Line=11 9 22 20 BUTTERFLYl
Rectangle=12 8 14 20 DIRT
Rectangle=16 8 18 20 DIRT
Rectangle=20 8 22 20 DIRT
Line=22 6 33 6 BOULDER
Line=22 5 33 5 FIREFLYl
Rectangle=23 4 25 7 DIRT
Rectangle=27 4 29 7 DIRT
Rectangle=31 4 33 7 DIRT
Point=3 1 INBOX
Point=39 18 OUTBOX
[/objects]
[/cave]

[cave]
Name=Cave O. Funnel
Intermission=false
IntermissionProperties.instantlife=true
IntermissionProperties.rewardlife=false
Charset=Original
Fontset=Original
Size=40 22 0 0 39 21
Colors=Black Black Orange LightBlue White White Orange
DiamondsRequired=30 35 35 35 40
DiamondValue=10 20
CaveTime=140 160 180 180 180
TimeValue=5 6 7 8 9
CaveScheduling=bd1
FrameTime=200 200 200 200 200
CaveDelay=0 0 0 0 0
RandSeed=32 47 35 11 2
RandomFill=SPACE 100 BOULDER 80 FIREFLYl 2 DIRT 0
ActiveGuyIsFirst=false
MagicWallTime=8 8 8 8 8
SlimePermeabilityC64=0 0 0 0 0
BorderProperties.lineshift=true
BorderProperties.objectwraparound=true

[objects]
Line=2 2 11 11 WALL
Line=15 11 24 2 WALL
Line=12 12 14 12 DIRT
Line=12 13 14 13 MAGICWALL
Point=20 20 OUTBOX
Point=20 1 INBOX
[/objects]
[/cave]

[cave]
Name=Cave P. Enchanted boxes
Intermission=false
IntermissionProperties.instantlife=true
IntermissionProperties.rewardlife=false
Charset=Original
Fontset=Original
Size=40 22 0 0 39 21
Colors=Black Black Brown LightRed White White Brown
DiamondsRequired=12 18 21 24 27
DiamondValue=10 20
CaveTime=150 150 180 201 222
TimeValue=5 6 7 8 9
CaveScheduling=bd1
FrameTime=200 200 200 200 200
CaveDelay=0 0 0 0 0
RandSeed=123 138 132 135 141
RandomFill=BOULDER 50 DIRT 0 DIRT 0 DIRT 0
ActiveGuyIsFirst=false
MagicWallTime=20 20 20 20 20
SlimePermeabilityC64=0 0 0 0 0
BorderProperties.lineshift=true
BorderProperties.objectwraparound=true

[objects]
Point=1 1 INBOX
Point=39 2 OUTBOX
FillRect=8 17 11 20 DIRT SPACE
Point=10 18 FIREFLYl
Rectangle=7 8 12 15 WALL
Line=7 8 12 8 MAGICWALL
FillRect=16 17 19 20 DIRT SPACE
Point=18 18 FIREFLYl
Rectangle=15 8 20 15 WALL
Line=15 8 20 8 MAGICWALL
FillRect=24 17 27 20 DIRT SPACE
Point=26 18 FIREFLYl
FillRect=32 17 35 20 DIRT SPACE
Point=34 18 FIREFLYl
[/objects]
[/cave]

[cave]
Name=Intermission 4
Intermission=true
IntermissionProperties.instantlife=true
IntermissionProperties.rewardlife=false
Charset=Original
Fontset=Original
Size=40 22 0 0 19 11
Colors=Black Black Blue Orange White White Blue
DiamondsRequired=6 6 6 6 6
DiamondValue=30 0
CaveTime=20 20 20 20 20
TimeValue=5 6 7 8 9
CaveScheduling=bd1
FrameTime=200 200 200 200 200
CaveDelay=0 0 0 0 0
ActiveGuyIsFirst=false
MagicWallTime=3 3 3 3 3
SlimePermeabilityC64=0 0 0 0 0
BorderProperties.lineshift=true
BorderProperties.objectwraparound=true

[objects]
FillRect=19 0 39 21 STEELWALL
FillRect=0 11 39 21 STEELWALL
Rectangle=11 1 13 2 BOULDER
FillRect=11 5 13 10 SPACE
Line=11 4 13 4 MAGICWALL
Line=11 8 13 8 MAGICWALL
Line=8 5 10 7 BOULDER
Point=3 1 INBOX
Point=9 8 OUTBOX
[/objects]
[/cave]
[/game]
[/BDCFF]