[BDCFF]
Version=0.5

[game]
Name=HOP 4
Author=Persoft
Levels=5

[cave]
Name=Cave 01
IntermissionProperties.instantlife=true
Intermission=false
IntermissionProperties.rewardlife=false
Size=40 22 0 0 39 21
Colors=Atari00 Atari00 Ataria4 Atari46 Atari0c Atarid4 Atarid4
DiamondsRequired=33 33 33 33 33
CaveTime=255 255 255 255 255
CaveScheduling=bd2ckatari
PALTiming=true
FrameTime=140 140 140 140 140
CaveDelay=7 7 7 7 7
TimeValue=1 1 1 1 1
DiamondValue=2 50
RandSeed=0 0 0 0 0
ActiveGuyIsFirst=false
AmoebaProperties.immediately=false
MagicWallTime=0 0 0 0 0
MagicWallProperties.convertamoeba=false
SlimePermeabilityC64=0 0 0 0 0
BorderProperties.lineshift=true
BorderProperties.objectwraparound=true
BorderProperties.scan=false

[map]
WWWWWWWWWWWWWWWWWWWWWWWWWWWWWWWWWWWWWWWW
W.............d.W.... ....w...... .wr..W
W...d.w...........W...w......ddd.....P.W
W...dw.d........r...wwwwwwwwwwwwrwwwwwwW
Wwwww..wwwwwwwwwwwww.................d.W
W.. ...w.............................d W
Wd.......W......r.................W..d.W
W.r.r. d.........d.. ..d.......r.....r.W
W..........WW...........W.....d......w.W
W...w.wwwwwwwwwwwwwwwwwwwwwww.W........W
Wd.dW...w..... .........d....W.....ww..W
W..w....w.......W..........W........W..W
W.rrw...w... ...wWd.W..................W
W...w...w....r .w.wwwwwwwwwwwwwww......W
W...w...wr......w....d....wd....w......W
W...w...w. .....w.......r.wdw..dw.... WW
W ..w..dw.......w....r....wdwdr.w....w.W
Wd..w.d.w.r ....w.W......dwdw...wd.....W
W.d.wd..w...W......r... ..wdw...w.W....W
W..dwrd.w......... .......wdw ..w. ....W
W.r.w..ddwww...X..........wdw.......Ww.W
WWWWWWWWWWWWWWWWWWWWWWWWWWWWWWWWWWWWWWWW
[/map]
[/cave]

[cave]
Name=Cave 02
IntermissionProperties.instantlife=true
Intermission=false
IntermissionProperties.rewardlife=false
Size=40 22 0 0 39 21
Colors=Atari00 Atari00 Ataria4 Atari46 Atari0c Atarid4 Atarid4
DiamondsRequired=33 33 33 33 33
CaveTime=255 255 255 255 255
CaveScheduling=bd2ckatari
PALTiming=true
FrameTime=140 140 140 140 140
CaveDelay=7 7 7 7 7
TimeValue=1 1 1 1 1
DiamondValue=2 80
RandSeed=0 0 0 0 0
ActiveGuyIsFirst=false
AmoebaProperties.immediately=false
MagicWallTime=100 100 100 100 100
MagicWallProperties.convertamoeba=false
SlimePermeabilityC64=0 0 0 0 0
BorderProperties.lineshift=true
BorderProperties.objectwraparound=true
BorderProperties.scan=false

[map]
WWWWWWWWWWWWWWWWWWWWWWWWWWWWWWWWWWWWWWWW
WP.........rrrrrrrrr.rrrrrrrr..........W
W...............................W......W
W...............................W......W
W...............................W......W
WWWWWWWWWW.MMMMMMMMMMMMMMMMMw...W......W
W..........M................M ..W......W
W.WWWWWWWWWM................M ..W......W
W..........Mr.....r.........M ..W......W
WWWWWWWWWW.Mr.....r.........M ..W......W
W..........Mr.....r.........M ..W......W
W.WWWWWWWWWMr.....r.........M ..W......W
W..........Mr.....r.........M ..W......W
WWWWWWWWWW.M................M ..WWWWWWWW
W..........M................M     .....W
W.WWWWWWWWWM................M.... .....W
W..........MMMMMMMMMMMMMMMMMM.... .....X
W..WdWdW......................... .....W
W..WdWdW......................... .....W
W..WdWdW......................... .....W
W.WddWddW........................Q.....W
WWWWWWWWWWWWWWWWWWWWWWWWWWWWWWWWWWWWWWWW
[/map]
[/cave]

[cave]
Name=Cave 03
IntermissionProperties.instantlife=true
Intermission=false
IntermissionProperties.rewardlife=false
Size=40 22 0 0 39 21
Colors=Atari00 Atari00 Ataria4 Atari46 Atari0c Atarid4 Atarid4
DiamondsRequired=33 33 33 33 33
CaveTime=255 255 255 255 255
CaveScheduling=bd2ckatari
PALTiming=true
FrameTime=140 140 140 140 140
CaveDelay=7 7 7 7 7
TimeValue=1 1 1 1 1
DiamondValue=2 3
RandSeed=0 0 0 0 0
ActiveGuyIsFirst=false
AmoebaProperties.immediately=false
MagicWallTime=0 0 0 0 0
MagicWallProperties.convertamoeba=false
SlimePermeabilityC64=0 0 0 0 0
BorderProperties.lineshift=true
BorderProperties.objectwraparound=true
BorderProperties.scan=false

[map]
WWWWWWWWWWWWWWWWWWWWWWWWWWWWWWWWWWWWWWWW
W...................r.c   r.....X......W
W.......r.r............r. .............W
W..........r............. .........  c.W
W...........c.r.....c.r.. ......... .r.W
W........... ....... ....  .r...... ...W
W........... ....... ....r ........ . .W
W.....c..... ....r.. ..... . ...P.. . .W
W..... ..... r..r... ...r. . .r....   .W
W.r... ..... ....... ....r . ......r.r.W
W..... . ... r..r... .r...   .. .... ..W
W..... . ..r..............r.... ..r. ..W
W....... ...r. .......c....r... .... ..W
W.......c..... ....... .r..r...cr... ..W
W....... ..... ....... .........r... ..W
W..r....r..... ....... ..c.c..c..... ..W
W............. ...r...r.. . .. ..... ..W
W....c........ ........cc . .. .....c..W
W.... ........c........   . .. .....c..W
W.... ........ ......r.   . ..r.......rW
W.... ........ ...c....   . ...........W
WWWWWWWWWWWWWWWWWWWWWWWWWWWWWWWWWWWWWWWW
[/map]
[/cave]

[cave]
Name=Cave 04
IntermissionProperties.instantlife=true
Intermission=false
IntermissionProperties.rewardlife=false
Size=40 22 0 0 39 21
Colors=Atari00 Atari00 Ataria4 Atari46 Atari0c Atarid4 Atarid4
DiamondsRequired=99 99 99 99 99
CaveTime=255 255 255 255 255
CaveScheduling=bd2ckatari
PALTiming=true
FrameTime=140 140 140 140 140
CaveDelay=7 7 7 7 7
TimeValue=1 1 1 1 1
DiamondValue=1 2
RandSeed=0 0 0 0 0
ActiveGuyIsFirst=false
AmoebaProperties.immediately=false
AmoebaTime=255 255 255 255 255
MagicWallTime=0 0 0 0 0
MagicWallProperties.convertamoeba=false
SlimePermeabilityC64=0 0 0 0 0
BorderProperties.lineshift=true
BorderProperties.objectwraparound=true
BorderProperties.scan=false

[map]
WWWWWWWWWWWWWWWWWWWWWWWWWWWWWWWWWWWWWWWW
X.....w................................W
W.....w.wwwwwwwwwwwwwwwwwwwwwwww.......W
W.....w.w......................w.......W
W.....w.w.wwwwwwwwwwwwwwwwwwww.w.......W
W.....w..P............a......w.w.......W
W.....w.w.w..................w.w.......W
W.....w.w.w..................w.w.......W
Wcccccw.w.w..................w.w...w...W
Wcccccw.w.w..................w.w...w...W
Wcccccw.w.w..................w.w...w...W
Wcccccw.w.w..................w.w...w...W
Wcccccw.w.w..................w.w...w...W
Wcccccw.w.w..................w.w...w...W
Wcccccw.w.w..................w.w...w...W
Wcccccw.w.wwwwwwwwwwwwwwwwwwww.w...w...W
Wcccccw.w......................w...w...W
Wcccccw.wwwwwwwwwwwwwwwwwwwwwwww...w...W
Wcccccw............................w...W
Wcccccwwwwwwwwwwwwwwwwwwwwwwwwwwwwww...W
W                              d.......W
WWWWWWWWWWWWWWWWWWWWWWWWWWWWWWWWWWWWWWWW
[/map]
[/cave]

[cave]
Name=Intermission 05
Selectable=false
IntermissionProperties.instantlife=true
Intermission=true
IntermissionProperties.rewardlife=false
Size=40 22 0 0 19 11
Colors=Atari00 Atari00 Ataria4 Atari46 Atari0c Atarid4 Atarid4
DiamondsRequired=4 4 4 4 4
CaveTime=255 255 255 255 255
CaveScheduling=bd2ckatari
PALTiming=true
FrameTime=140 140 140 140 140
CaveDelay=7 7 7 7 7
TimeValue=1 1 1 1 1
DiamondValue=70 99
RandSeed=0 0 0 0 0
ActiveGuyIsFirst=false
AmoebaProperties.immediately=false
MagicWallTime=6 6 6 6 6
MagicWallProperties.convertamoeba=false
SlimePermeabilityC64=0 0 0 0 0
BorderProperties.lineshift=true
BorderProperties.objectwraparound=true
BorderProperties.scan=false

[map]
WWWWWWWWWWWWWWWWWWWWWWWWWWWWWWWWWWWWWWWW
W                  WWWWWWWWWWWWWWWWWWWWW
W ................ WWWWWWWWWWWWWWWWWWWWW
W ..r.r.r.r.r...c. WWWWWWWWWWWWWWWWWWWWW
W .............. . WWWWWWWWWWWWWWWWWWWWW
W ..M.M.M.M.M... . WWWWWWWWWWWWWWWWWWWWW
W ............PX . WWWWWWWWWWWWWWWWWWWWW
W .............. . WWWWWWWWWWWWWWWWWWWWW
W                . WWWWWWWWWWWWWWWWWWWWW
W................. WWWWWWWWWWWWWWWWWWWWW
WF                 WWWWWWWWWWWWWWWWWWWWW
WWWWWWWWWWWWWWWWWWWWWWWWWWWWWWWWWWWWWWWW
WWWWWWWWWWWWWWWWWWWWWWWWWWWWWWWWWWWWWWWW
WWWWWWWWWWWWWWWWWWWWWWWWWWWWWWWWWWWWWWWW
WWWWWWWWWWWWWWWWWWWWWWWWWWWWWWWWWWWWWWWW
WWWWWWWWWWWWWWWWWWWWWWWWWWWWWWWWWWWWWWWW
WWWWWWWWWWWWWWWWWWWWWWWWWWWWWWWWWWWWWWWW
WWWWWWWWWWWWWWWWWWWWWWWWWWWWWWWWWWWWWWWW
WWWWWWWWWWWWWWWWWWWWWWWWWWWWWWWWWWWWWWWW
WWWWWWWWWWWWWWWWWWWWWWWWWWWWWWWWWWWWWWWW
WWWWWWWWWWWWWWWWWWWWWWWWWWWWWWWWWWWWWWWW
WWWWWWWWWWWWWWWWWWWWWWWWWWWWWWWWWWWWWWWW
[/map]
[/cave]

[cave]
Name=Cave 06
IntermissionProperties.instantlife=true
Intermission=false
IntermissionProperties.rewardlife=false
Size=40 22 0 0 39 21
Colors=Atari00 Atari00 Ataria4 Atari46 Atari0c Atarid4 Atarid4
DiamondsRequired=20 20 20 20 20
CaveTime=255 255 255 255 255
CaveScheduling=bd2ckatari
PALTiming=true
FrameTime=140 140 140 140 140
CaveDelay=7 7 7 7 7
TimeValue=1 1 1 1 1
DiamondValue=3 50
RandSeed=0 0 0 0 0
ActiveGuyIsFirst=false
AmoebaProperties.immediately=false
MagicWallTime=0 0 0 0 0
MagicWallProperties.convertamoeba=false
SlimePermeabilityC64=0 0 0 0 0
BorderProperties.lineshift=true
BorderProperties.objectwraparound=true
BorderProperties.scan=false

[map]
WWWWWWWWWWWWWWWWWWWWWWWWWWWWWWWWWWWWWWWW
WP.drr......rr.rr..d...r.....r..rr..r..W
Wr....r..rr...r.......rd..r.r.r..rr....W
Wdrr......d.drr.r.....r.rr.d...........W
W.......r......r.....r..rd.r...r.....d.W
W.........r.r.r.rr.r......rr...rr.r....W
X...r.r.rdr...r....rr.r.r...r...rr.r.rrW
Wr.r.r.....r.r...r....rr.r..d..........W
W...d.r.r.r.r.....r..r.....rr....d..r.rW
Wr...rrdr......r...........r...r.rr..rdW
W......r..rr..d.rr.rr..r.r...r....r....W
W.....r..rr...r.d.r...rr.drr.r..dr...r.W
W...rrr..rr..r.....r.rr.drr.r..rr.....rW
W.r..rdr..d.rr....rrrrr..r.....rr...drdW
W....r......dr...rrd.r.r...dr.r.r..r..rW
W.r....rr.r.drr...r...drr...r..........W
W.......r...r...rdr....r.r.r.d.r......rW
W........r..r....r......r.d....rr..rr..W
Wrr...rdr..r......r.r.........rrr..r...W
W...r.r..d.r..r.d.r......dr....drd.....W
Wr.rr...r....r......r.dr......rr.r....rW
WWWWWWWWWWWWWWWWWWWWWWWWWWWWWWWWWWWWWWWW
[/map]
[/cave]

[cave]
Name=Cave 07
IntermissionProperties.instantlife=true
Intermission=false
IntermissionProperties.rewardlife=false
Size=40 22 0 0 39 21
Colors=Atari00 Atari00 Ataria4 Atari46 Atari0c Atarid4 Atarid4
DiamondsRequired=1 1 1 1 1
CaveTime=255 255 255 255 255
CaveScheduling=bd2ckatari
PALTiming=true
FrameTime=140 140 140 140 140
CaveDelay=7 7 7 7 7
TimeValue=1 1 1 1 1
DiamondValue=99 2
RandSeed=0 0 0 0 0
ActiveGuyIsFirst=false
AmoebaProperties.immediately=false
AmoebaTime=255 255 255 255 255
MagicWallTime=0 0 0 0 0
MagicWallProperties.convertamoeba=false
SlimePermeabilityC64=0 0 0 0 0
BorderProperties.lineshift=true
BorderProperties.objectwraparound=true
BorderProperties.scan=false

[map]
WWWWWWWWWWWWWWWWWWWWWWWWWWWWWWWWWWWWWWWW
W.QQQQQQQQQQQQQ..........r.............W
W.QQQQQQQQQQQQQ........................W
W.QQQQQQQQQQQQQr.......................W
W........................r.....r.......W
W......................................W
W.QQQQQQQQQQQQQ........................W
W.QQQQQQQQQQQQQ.......WWWWWWWWWWWWW....W
W.QQQQQQQQQQQQQr.......dWaaaaaaaaaW....W
W.....................WWWaaaaaaaaaW....W
W.......................Waaaaaaaaaddr..W
W.QQQQQQQQQQQQQ.........WaaaaaaardW....W
W.QQQQQQQQQQQQQ....r....WaaaaaaaaaW....W
W.QQQQQQQQQQQQQr........WaaaWdW...W....W
W.......................WaaaWdW...W....W
W.......................WaaaWXW...W....W
W.QQQQQQQQQQQQQ.........WaaaWWd...W.r..W
W.QQQQQQQQQQQQQ.............W.dWWWW....W
W.QQQQQQQQQQQQQr...r........W..........W
W...........................W..........W
W...........................W.........PW
WWWWWWWWWWWWWWWWWWWWWWWWWWWWWWWWWWWWWWWW
[/map]
[/cave]

[cave]
Name=Cave 08
IntermissionProperties.instantlife=true
Intermission=false
IntermissionProperties.rewardlife=false
Size=40 22 0 0 39 21
Colors=Atari00 Atari00 Ataria4 Atari46 Atari0c Atarid4 Atarid4
DiamondsRequired=16 16 16 16 16
CaveTime=255 255 255 255 255
CaveScheduling=bd2ckatari
PALTiming=true
FrameTime=140 140 140 140 140
CaveDelay=7 7 7 7 7
TimeValue=1 1 1 1 1
DiamondValue=10 99
RandSeed=0 0 0 0 0
ActiveGuyIsFirst=false
AmoebaProperties.immediately=false
MagicWallTime=0 0 0 0 0
MagicWallProperties.convertamoeba=false
SlimePermeabilityC64=0 0 0 0 0
BorderProperties.lineshift=true
BorderProperties.objectwraparound=true
BorderProperties.scan=false

[map]
WWWWWWWWWWWWWWWWWWWWWWWWWWWWWWWWWWWWWWWW
XP...............Q.........d.Q...rQ.r.rW
W......d...............................W
W.....Q..............r......d..........W
W.................r.dwwwwwwwwwwwwwwwwrwW
WwwwwQwwwwwwwwwrwwww..............r....W
W.........Q...r........Qr........r.....W
W..............d.r..r..................W
W...................................r..W
W.........................d............W
W.......d.....r...d.dwwwwwwQrwwwwwwwwwwW
Wwwwrwwwwwwwwrwwwrww....d....r..Q...d..W
W....................rrQ......r...r....W
W.....r....................d...........W
W....r.r........Qd.....r....Q..........W
W...............d...dwwwwQwwwwwwwwwwwwwW
WwwwwwwQwwwwwrwwwwww.............QQ....W
W..d.......r..................d.....r..W
W.d..dr.r...r.Q................Q.....d.W
W........Q.d..............d...........rW
W........r.................Q....r..r...W
WWWWWWWWWWWWWWWWWWWWWWWWWWWWWWWWWWWWWWWW
[/map]
[/cave]

[cave]
Name=Cave 09
IntermissionProperties.instantlife=true
Intermission=false
IntermissionProperties.rewardlife=false
Size=40 22 0 0 39 21
Colors=Atari00 Atari00 Ataria4 Atari46 Atari0c Atarid4 Atarid4
DiamondsRequired=5 5 5 5 5
CaveTime=255 255 255 255 255
CaveScheduling=bd2ckatari
PALTiming=true
FrameTime=140 140 140 140 140
CaveDelay=7 7 7 7 7
TimeValue=1 1 1 1 1
DiamondValue=77 99
RandSeed=0 0 0 0 0
ActiveGuyIsFirst=false
AmoebaProperties.immediately=false
MagicWallTime=100 100 100 100 100
MagicWallProperties.convertamoeba=false
SlimePermeabilityC64=0 0 0 0 0
BorderProperties.lineshift=true
BorderProperties.objectwraparound=true
BorderProperties.scan=false

[map]
WWWWWWWWWWWWWWWWWWWWWWWWWWWWWWWWWWWWWWWW
W............w..r.........M.M...w......W
W...w.wwMw...... .....M......w.........W
W...w....w...... ...ww.......M.........W
W..M..M......w.w r.....................W
W.............w. ....w..ww..w..w..w..w.W
X.......w..w..w. .................w....W
W...ww.r.......rMw..w.......r..w...w...W
W....w.w...w.... ...........M......www.W
WMrww......M........M.............rw.M.W
W........r.w...........r.......M.wr....W
W....w..........w..r...w...w..w........W
Wr.w.................ww........wM.rr...W
W......w....r.wM...w.w....ww....w......W
W.....ww.........w...........w..w.w....W
W.....w......w.............wwr.....w.w.W
W.....r.......w..w..........w..........W
W.w.w...w..........w..........r...rw...W
W...........w.....wMw......w.......MM.wW
W...............ww...ww.............w.PW
W......r.......r...w.wM.....Mw........wW
WWWWWWWWWWWWWWWWWWWWWWWWWWWWWWWWWWWWWWWW
[/map]
[/cave]

[cave]
Name=Intermission 10
Selectable=false
IntermissionProperties.instantlife=true
Intermission=true
IntermissionProperties.rewardlife=false
Size=40 22 0 0 19 11
Colors=Atari00 Atari00 Ataria4 Atari46 Atari0c Atarid4 Atarid4
DiamondsRequired=99 99 99 99 99
CaveTime=100 100 100 100 100
CaveScheduling=bd2ckatari
PALTiming=true
FrameTime=80 80 80 80 80
CaveDelay=4 4 4 4 4
TimeValue=1 1 1 1 1
DiamondValue=1 2
RandSeed=0 0 0 0 0
ActiveGuyIsFirst=false
AmoebaProperties.immediately=false
AmoebaTime=60 60 60 60 60
MagicWallTime=0 0 0 0 0
MagicWallProperties.convertamoeba=false
SlimePermeabilityC64=0 0 0 0 0
BorderProperties.lineshift=true
BorderProperties.objectwraparound=true
BorderProperties.scan=false

[map]
WWWWWWWWWWWWWWWWWWWWWWWWWWWWWWWWWWWWWWWW
W.........w........WWWWWWWWWWWWWWWWWWWWW
WWWWWWWWWWw........WWWWWWWWWWWWWWWWWWWWW
W.........w........WWWWWWWWWWWWWWWWWWWWW
W.........w........WWWWWWWWWWWWWWWWWWWWW
Wa.a.aa.aar...w....WWWWWWWWWWWWWWWWWWWWW
Xa.a.aa.aaw........WWWWWWWWWWWWWWWWWWWWW
Waaa.aa.a.w.P......WWWWWWWWWWWWWWWWWWWWW
Wa.a.aa.a.w........WWWWWWWWWWWWWWWWWWWWW
W........Ww........WWWWWWWWWWWWWWWWWWWWW
W.......W.w........WWWWWWWWWWWWWWWWWWWWW
WWWWWWWWWWWWWWWWWWWWWWWWWWWWWWrWWWWWWWWW
WWWWWWWWWWWWWWWWWWWWWWWWWWWWWWWWWWWWWWWW
WWWWWWWWWWWWWWWWWWWWWWWWWWWWWWWWWWWWWWWW
WWWWWWWWWWWWWWWWWWWWWWWWWWWWWWWWWWWWWWWW
WWWWWWWWWWWWWWWWWWWWWWWWWWWWWWWWWWWWWWWW
WWWWWWWWWWWWWWWWWWWWWWWWWWWWWWWWWWWWWWWW
WWWWWWWWWWWWWWWWWWWWWWWWWWWWWWWWWWWWWWWW
WWWWWWWWWWWWWWWWWWWWWWWWWWWWWWWWWWWWWWWW
WWWWWWWWWWWWWWWWWWWWWWWWWWWWWWWWWWWWWWWW
WWWWWWWWWWWWWWWWWWWWWWWWWWWWWWWWWWWWWWWW
WWWWWWWWWWWWWWWWWWWWWWWWWWWWWWWWWWWWWWWW
[/map]
[/cave]

[cave]
Name=Cave 11
IntermissionProperties.instantlife=true
Intermission=false
IntermissionProperties.rewardlife=false
Size=40 22 0 0 39 21
Colors=Atari00 Atari00 Ataria4 Atari46 Atari0c Atarid4 Atarid4
DiamondsRequired=99 99 99 99 99
CaveTime=255 255 255 255 255
CaveScheduling=bd2ckatari
PALTiming=true
FrameTime=140 140 140 140 140
CaveDelay=7 7 7 7 7
TimeValue=1 1 1 1 1
DiamondValue=1 3
RandSeed=0 0 0 0 0
ActiveGuyIsFirst=false
AmoebaProperties.immediately=false
MagicWallTime=0 0 0 0 0
MagicWallProperties.convertamoeba=false
SlimePermeabilityC64=0 0 0 0 0
BorderProperties.lineshift=true
BorderProperties.objectwraparound=true
BorderProperties.scan=false

[map]
WWWWWWWWWWWWWWWWWWWWWWWWWWWWWWWWWWWWWWWW
WrrddddddddddddddddddddddddddddddddddddW
Wdddrrrrrrr.rrrrrrrrrrrrrrrrrrr.rrrrrrdW
Wrrrrrrrrrdrrrrr.r.rrrrrrrrrrrrrrrr.rrdW
Xrrrrrr.rrdrrrrrrrrrrrrrrdrrrrrrrrrrrrdW
Wrrrrrrrrrdrrrrrrrrrrrrrrdrrrr.rrrrrrrdW
WrddddddddddddddddddrrrrrdrrrrrrrrrrrrdW
WdrrrrrrrrrrrrrrrrrrrrrrrdrrrrrrrrrrrrdW
WdrrrrrrrrrrrrrrrrrrdddddddddddddddrrrdW
Wdrrrrrrrrrrrr.rrrrrrrrrrdrrrrrrrrrrrrdW
Wdrrrrrrrrrrrrrrrrrrr.rrrdrrrrrrrrrrdrdW
Wdddddddddddddddddddrrr..ddddddddddddrdW
Wrdrrrd.rrrrrrrrrdrdrrrrrrrrrr.rrrrrdrdW
Wrdrrrdrrrrrrr.rrdrdrrr.rrrrrrrrrrrrdrdW
Wrdrrrdrrrrrrrrrrdrdrrrrrr.rrrrrrrrrdrdW
WPdddddrrrrrrrrrrdrdrrrrrrrrrrrrr.rrdrdW
Wrdrrrdrrr.rrrrr.drd.rrrrr.rrrrrrrrrdrdW
Wrdrrrdrr.rrrrrrrdrd.rrrrrrrrrrr.rrrdrdW
Wrdrrrdrrrrrr..rrdrd.rrrrrrrrrrrrrrrdrdW
Wrd..rdrrrrrrrrrrdrd..rrrrrrrrrrrrrrdrdW
WddddddrrrrrrrrrrdrddddddddddddddddddddW
WWWWWWWWWWWWWWWWWWWWWWWWWWWWWWWWWWWWWWWW
[/map]
[/cave]

[cave]
Name=Cave 12
IntermissionProperties.instantlife=true
Intermission=false
IntermissionProperties.rewardlife=false
Size=40 22 0 0 39 21
Colors=Atari00 Atari00 Ataria4 Atari46 Atari0c Atarid4 Atarid4
DiamondsRequired=1 1 1 1 1
CaveTime=6 6 6 6 6
CaveScheduling=bd2ckatari
PALTiming=true
FrameTime=100 100 100 100 100
CaveDelay=5 5 5 5 5
TimeValue=1 1 1 1 1
DiamondValue=99 1
RandSeed=0 0 0 0 0
ActiveGuyIsFirst=false
AmoebaProperties.immediately=false
MagicWallTime=0 0 0 0 0
MagicWallProperties.convertamoeba=false
SlimePermeabilityC64=0 0 0 0 0
BorderProperties.lineshift=true
BorderProperties.objectwraparound=true
BorderProperties.scan=false

[map]
WWWWWWWWWWWWWWWWWWWWWWWWWWWWWWWWWWWWWWWW
Wd.....................................W
Wxxxxxxxxxxxxxxxxxxxxxxxxx....xxxxxxxx.W
Wd................     c......Q   .....W
Wxxxxxxxxxxxxxxxxxxxxxxxxx....xxxxxxxxdW
Wd.....................................W
Wxxxxxxxxxxxxxxxxxxxxxxxxx.PW.xxxxxxxxdW
Wd.....................................W
Wxxxxxxxxxxxxxxxxxxxxxxxxx....xxxxxxxxdW
Wd.....................................W
Wxxxxxxxxxxxxxxxxxxxxxxxxx....xxxxxxxxdW
Wd.....................................W
Wxxxxxxxxxxxxxxxxxxxxxxxxx....xxxxxxxxdW
Wd.....................................W
Wxxxxxxxxxxxxxxxxxxxxxxxxxx.x.x........W
W.........................x.x.x........W
W.........................x.x.x....a...W
Wxxxxxxxxxxxxxxxxxxx......x.x.x.xxxxxxxW
Xd........................x.x.x........W
Wxxxxxxxxxxxxxx.xxxxxxxxxxx.x.xxxxxxxxxW
W...........................x.........dW
WWWWWWWWWWWWWWWWWWWWWWWWWWWWWWWWWWWWWWWW
[/map]
[/cave]

[cave]
Name=Cave 13
IntermissionProperties.instantlife=true
Intermission=false
IntermissionProperties.rewardlife=false
Size=40 22 0 0 39 21
Colors=Atari00 Atari00 Ataria4 Atari46 Atari0c Atarid4 Atarid4
DiamondsRequired=99 99 99 99 99
CaveTime=255 255 255 255 255
CaveScheduling=bd2ckatari
PALTiming=true
FrameTime=140 140 140 140 140
CaveDelay=7 7 7 7 7
TimeValue=1 1 1 1 1
DiamondValue=1 1
RandSeed=0 0 0 0 0
ActiveGuyIsFirst=false
AmoebaProperties.immediately=false
MagicWallTime=0 0 0 0 0
MagicWallProperties.convertamoeba=false
SlimePermeabilityC64=0 0 0 0 0
BorderProperties.lineshift=true
BorderProperties.objectwraparound=true
BorderProperties.scan=false

[map]
WWWWWWWWWWWWWWWWWWWWWWWWWWWWWWWWWWWWWWWW
X......a.........r.W...................W
W......................................W
W......................................W
W................r.............rr......W
W.................................r....W
W......................................W
W.................rP...................W
W......................................W
W......................................W
W.................WW.WWWWWWWWWWWWWWWWWWW
W..................W.W...ccccccccccccccW
W..................W.W...ccccccccccccccW
W..................W.W...ccccccccccccccW
WWWWWWWWWWWWWWWWWW.W.W...ccccccccccccccW
Wcccccccccccccccr..W.W...ccccccccccccccW
Wccccccccccccccc...W.Wr..ccccccccccccccW
Wccccccccccccccc...W.W...ccccccccccccccW
Wccccccccccccccc  dW.Wd  ccccccccccccccW
Wccccccccccccccc ....... ccccccccccccccW
Wccccccccccccccc.........ccccccccccccccW
WWWWWWWWWWWWWWWWWWWWWWWWWWWWWWWWWWWWWWWW
[/map]
[/cave]

[cave]
Name=Cave 14
IntermissionProperties.instantlife=true
Intermission=false
IntermissionProperties.rewardlife=false
Size=40 22 0 0 39 21
Colors=Atari00 Atari00 Ataria4 Atari46 Atari0c Atarid4 Atarid4
DiamondsRequired=1 1 1 1 1
CaveTime=255 255 255 255 255
CaveScheduling=bd2ckatari
PALTiming=true
FrameTime=140 140 140 140 140
CaveDelay=7 7 7 7 7
TimeValue=1 1 1 1 1
DiamondValue=99 99
RandSeed=0 0 0 0 0
ActiveGuyIsFirst=false
AmoebaProperties.immediately=false
MagicWallTime=0 0 0 0 0
MagicWallProperties.convertamoeba=false
SlimePermeabilityC64=0 0 0 0 0
BorderProperties.lineshift=true
BorderProperties.objectwraparound=true
BorderProperties.scan=false

[map]
WWWWWWWWWWWWWWWWWWWWWWWWWWWWWWWWWWWWWWWW
WH..r.rr.r.r....Wrrr.rr........rW..rrrrW
Wrr..rrrrrr.r.r.rrrrr.r.rrr.r....rr..r.W
W.rrrr.rr.rrr..r.r.....r.rrr.r.rrr.rrr.W
Wrrr.rrr..rrrrrrrrrrrrrrr..rr...rr.rr..W
Wr..r.r.....rr..rrr.r.rr.r..rr..rr....rW
W..rr.rrr.rr.r.rrr...r.rr.r.r..rrr..r.rW
Wrr.r.rr.rrr....rr..rrrrrrr.r.rrr...r.rW
W.r...rrrrrr.r.rr.rrrrrrrrr.r.r.....rr.W
Wrrrrr.r.rrr....rrrrrrrrr.rr..rr..rrrrrW
W.r.r.rrrr..rrr.r....rrrr.rr.rr.r.rrr.rW
W.r...r.rr.r.rr.rr.r.rr..r....r.r.rrrr.W
Wr.rrr..rrr.rrr.rrrrr..rrr...rr.r.rrrrrW
W..rrrrrr.rr.r..rrr..r..r..rrr.rrrrr.r.W
W.rr..rrr..r..rr..rr.r...rr.rr.r.rrrrrrW
Wr...r..rrrrr.rr.r...rr.rrr...rr....rrrW
W                                      W
W                                      W
WW                         P         W W
Wrrr.rrr..rr..rr.r.r.rrdrrr..r..r.rr.rrW
W.r.rr.r.rr..rrrr.rr.r.dddr.....rr.rr.rW
WWWWWWWWWWWWWWWWWWWWWWWWWWWWWWWWWWWWWWWW
[/map]
[/cave]

[cave]
Name=Intermission 15
Selectable=false
IntermissionProperties.instantlife=true
Intermission=true
IntermissionProperties.rewardlife=false
Size=40 22 0 0 19 11
Colors=Atari00 Atari00 Ataria4 Atari46 Atari0c Atarid4 Atarid4
DiamondsRequired=1 1 1 1 1
CaveTime=255 255 255 255 255
CaveScheduling=bd2ckatari
PALTiming=true
FrameTime=140 140 140 140 140
CaveDelay=7 7 7 7 7
TimeValue=1 1 1 1 1
DiamondValue=99 99
RandSeed=0 0 0 0 0
ActiveGuyIsFirst=false
AmoebaProperties.immediately=false
MagicWallTime=0 0 0 0 0
MagicWallProperties.convertamoeba=false
SlimePermeabilityC64=0 0 0 0 0
BorderProperties.lineshift=true
BorderProperties.objectwraparound=true
BorderProperties.scan=false

[map]
WWWWWWWWWWWWWWWWWWWWWWWWWWWWWWWWWWWWWWWW
W .Q..  Q  Q.waaaaaWWWWWWWWWWWWWWWWWWWWW
W  Q..   . ..wwwwwrWWWWWWWWWWWWWWWWWWWWW
W  ..   ....   .. rWWWWWWWWWWWWWWWWWWWWW
W .  . ...Q .   . .WWWWWWWWWWWWWWWWWWWWW
W Q .Q. Q.Q   . . .WWWWWWWWWWWWWWWWWWWWW
WX... ..Q   . .Q. .WWWWWWWWWWWWWWWWWWWWW
W  ....   .....dP..WWWWWWWWWWWWWWWWWWWWW
W .Q.. . ..    ....WWWWWWWWWWWWWWWWWWWWW
WQ.Q.  Q.  .. Q. . WWWWWWWWWWWWWWWWWWWWW
W ....   ..Q QQ   .WWWWWWWWWWWWWWWWWWWWW
WWWWWWWWWWWWWWWWWWWWWWWWWWWWWWWWWWWWWWWW
WWWWWWWWWWWWWWWWWWWWWWWWWWWWWWWWWWWWWWWW
WWWWWWWWWWWWWWWWWWWWWWWWWWWWWWWWWWWWWWWW
WWWWWWWWWWWWWWWWWWWWWWWWWWWWWWWWWWWWWWWW
WWWWWWWWWWWWWWWWWWWWWWWWWWWWWWWWWWWWWWWW
WWWWWWWWWWWWWWWWWWWWWWWWWWWWWWWWWWWWWWWW
WWWWWWWWWWWWWWWWWWWWWWWWWWWWWWWWWWWWWWWW
WWWWWWWWWWWWWWWWWWWWWWWWWWWWWWWWWWWWWWWW
WWWWWWWWWWWWWWWWWWWWWWWWWWWWWWWWWWWWWWWW
WWWWWWWWWWWWWWWWWWWWWWWWWWWWWWWWWWWWWWWW
WWWWWWWWWWWWWWWWWWWWWWWWWWWWWWWWWWWWWWWW
[/map]
[/cave]
[/game]
[/BDCFF]
