[BDCFF]
Version=0.5

[game]
Name=Mini
Levels=5

[cave]
Name=Cave 01
IntermissionProperties.instantlife=true
Intermission=false
IntermissionProperties.rewardlife=false
Size=40 22 0 0 39 21
Colors=Black Black Blue Red White White White
DiamondsRequired=33 33 33 33 33
CaveTime=200 200 200 200 200
CaveScheduling=plck
PALTiming=true
FrameTime=140 140 140 140 140
CaveDelay=7 7 7 7 7
TimeValue=1 1 1 1 1
DiamondValue=20 50
RandSeed=0 0 0 0 0
ActiveGuyIsFirst=false
AmoebaProperties.immediately=false
AmoebaTime=100 100 100 100 100
MagicWallTime=0 0 0 0 0
MagicWallProperties.convertamoeba=false
SlimePermeabilityC64=0 0 0 0 0
BorderProperties.lineshift=true
BorderProperties.objectwraparound=true
BorderProperties.scan=false

[map]
WWWWWWWWWWWWWWWWWWWWWWWWWWWWWWWWWWWWWWWW
WWWWWWWWWWWWWWWWWWWWWWWWWWWWWWWWWWWWWWWW
WWWWWWWWWWWWWWWWWWWWWWWWWWWWWWWWWWWWWWWW
WWWWWWWWWWWWWWWWWWWWWWWWWWWWWWWWWWWWWWWW
WWWWWWWWWWWWWWWWWWWWWWWWWWWWWWWWWWWWWWWW
WWWWWWWWWWWWWWWWWWWWWWWWWWWWWWWWWWWWWWWW
WWWWWWWWWWWWWWWWWWWWWWWWWWWWWWWWWWWWWWWW
WWWWWWWWWWWWWWWWWWWWWWWWWWWWWWWWWWWWWWWW
WWWWWWWWWWWWWWWWWWWWWWWWWWWWWWWWWWWWWWWW
WWWWWWWWWWWWWWWWWWWWWWWWWWWWWWWWWWWWWWWW
WWWWWWWWWWWWWWWWWWWWWWWWWWWWWXWWWWWWWWWW
WWWWWWWWWWWWWWWWWWWW...................W
WWWWWWWWWWWWWWWWWWWW...................W
WWWWWWWWWWWWWWWWWWWW.r...r..rrr..r...r.W
WWWWWWWWWWWWWWWWWWWW.rr.rr.r...r..r.r..W
WWWWWWWWWWWWWWWWWWWW.r.r.r.rrrrr...r...W
WWWWWWWWWWWWWWWWWWWW.r...r.r...r..r.r..W
WWWWWWWWWWWWWWWWWWWW.r...r.r...r.r...r.W
WWWWWWWWWWWWWWWWWWWW...................W
WWWWWWWWWWWWWWWWWWWW.ccccc...P...ccccc.W
WWWWWWWWWWWWWWWWWWWW...................W
WWWWWWWWWWWWWWWWWWWWWWWWWWWWWWWWWWWWWWWW
[/map]
[/cave]

[cave]
Name=Cave 02
IntermissionProperties.instantlife=true
Intermission=false
IntermissionProperties.rewardlife=false
Size=40 22 0 0 39 21
Colors=Black Black LightBlue Brown Yellow Yellow Yellow
DiamondsRequired=99 99 99 99 99
CaveTime=186 186 186 186 186
CaveScheduling=plck
PALTiming=true
FrameTime=140 140 140 140 140
CaveDelay=7 7 7 7 7
TimeValue=1 1 1 1 1
DiamondValue=10 0
RandSeed=0 0 0 0 0
ActiveGuyIsFirst=false
AmoebaProperties.immediately=false
AmoebaTime=1 1 1 1 1
MagicWallTime=0 0 0 0 0
MagicWallProperties.convertamoeba=false
SlimePermeabilityC64=0 0 0 0 0
BorderProperties.lineshift=true
BorderProperties.objectwraparound=true
BorderProperties.scan=false

[map]
WWWWWWWWWWWWWWWWWWWWWWWWWWWWWWWWWWWWWWWW
WWWWWWWWWWWWWWWWWWWWWWWWWWWWWWWWWWWWWWWW
WWWWWWWWWWWWWWWWWWWWWWWWWWWWWWWWWWWWWWWW
WWWWWWWWWWWWWWWWWWWWWWWWWWWWWWWWWWWWWWWW
WWWWWWWWWWWWWWWWWWWWWWWWWWWWWWWWWWWWWWWW
WWWWWWWWWWWWWWWWWWWWWWWWWWWWWWWWWWWWWWWW
WWWWWWWWWWWWWWWWWWWWWWWWWWWWWWWWWWWWWWWW
WWWWWWWWWWWWWWWWWWWWWWWWWWWWWWWWWWWWWWWW
WWWWWWWWWWWWWWWWWWWWWWWWWWWWWWWWWWWWWWWW
WWWWWWWWWWWWWWWWWWWWWWWWWWWWWWWWWWWWWWWW
WWWWWWWWWWWWWWWWWWWWWWWWWWWWWWWWWWWWWWWW
WWWWWWWWWWWWWWWWWWWWXddddddddddddddddddW
WWWWWWWWWWWWWWWWWWWWrrrrrrrrrrrrrrrrrrrW
WWWWWWWWWWWWWWWWWWWWrdrdrdrdrdrdrdrdrdrW
WWWWWWWWWWWWWWWWWWWWdddddddddddddddddddW
WWWWWWWWWWWWWWWWWWWWrrrrrrrrrrrrrrrrrrrW
WWWWWWWWWWWWWWWWWWWWdddddddddddddddddddW
WWWWWWWWWWWWWWWWWWWWddddddddd.dddddddddW
WWWWWWWWWWWWWWWWWWWWrrrrrrrrr.rrrrrrrrrW
WWWWWWWWWWWWWWWWWWWWdddddddd.P.ddddddddW
WWWWWWWWWWWWWWWWWWWW...................W
WWWWWWWWWWWWWWWWWWWWWWWWWWWWWWWWWWWWWWWW
[/map]
[/cave]

[cave]
Name=Cave 03
IntermissionProperties.instantlife=true
Intermission=false
IntermissionProperties.rewardlife=false
Size=40 22 0 0 39 21
Colors=Black Black Blue Orange Red Red Red
DiamondsRequired=99 99 99 99 99
CaveTime=202 202 202 202 202
CaveScheduling=plck
PALTiming=true
FrameTime=140 140 140 140 140
CaveDelay=7 7 7 7 7
TimeValue=1 1 1 1 1
DiamondValue=10 0
RandSeed=0 0 0 0 0
ActiveGuyIsFirst=false
AmoebaProperties.immediately=false
AmoebaTime=1 1 1 1 1
MagicWallTime=0 0 0 0 0
MagicWallProperties.convertamoeba=false
SlimePermeabilityC64=0 0 0 0 0
BorderProperties.lineshift=true
BorderProperties.objectwraparound=true
BorderProperties.scan=false

[map]
WWWWWWWWWWWWWWWWWWWWWWWWWWWWWWWWWWWWWWWW
WWWWWWWWWWWWWWWWWWWWWWWWWWWWWWWWWWWWWWWW
WWWWWWWWWWWWWWWWWWWWWWWWWWWWWWWWWWWWWWWW
WWWWWWWWWWWWWWWWWWWWWWWWWWWWWWWWWWWWWWWW
WWWWWWWWWWWWWWWWWWWWWWWWWWWWWWWWWWWWWWWW
WWWWWWWWWWWWWWWWWWWWWWWWWWWWWWWWWWWWWWWW
WWWWWWWWWWWWWWWWWWWWWWWWWWWWWWWWWWWWWWWW
WWWWWWWWWWWWWWWWWWWWWWWWWWWWWWWWWWWWWWWW
WWWWWWWWWWWWWWWWWWWWWWWWWWWWWWWWWWWWWWWW
WWWWWWWWWWWWWWWWWWWWWWWWWWWWWWWWWWWWWWWW
WWWWWWWWWWWWWWWWWWWWWWWWWWWWWWWWWWWWWWWW
WWWWWWWWWWWWWWWWWWWWQWQWQWWWWQWWWWQWQWQW
WWWWWWWWWWWWWWWWWWWWdWdWdWWWdddWWWdWdWdW
WWWWWWWWWWWWWWWWWWWWdWdWdWWdddddWWdWdWdW
WWWWWWWWWWWWWWWWWWWWdWdWdWdddddddWdWdWdW
WWWWWWWWWWWWWWWWWWWWdWdWdWdddXdddWdWdWdW
WWWWWWWWWWWWWWWWWWWWdWdWdWdddddddWdWdWdW
WWWWWWWWWWWWWWWWWWWWdWdWdWWdddddWWdWdWdW
WWWWWWWWWWWWWWWWWWWWdWdWdWWWdddWWWdWdWdW
WWWWWWWWWWWWWWWWWWWWdddddWWWWdWWWWdddddW
WWWWWWWWWWWWWWWWWWWWddddd    P    dddddW
WWWWWWWWWWWWWWWWWWWWWWWWWWWWWWWWWWWWWWWW
[/map]
[/cave]

[cave]
Name=Cave 04
IntermissionProperties.instantlife=true
Intermission=false
IntermissionProperties.rewardlife=false
Size=40 22 0 0 39 21
Colors=Black Black Orange Red Yellow Yellow Yellow
DiamondsRequired=3 3 3 3 3
CaveTime=100 100 100 100 100
CaveScheduling=plck
PALTiming=true
FrameTime=140 140 140 140 140
CaveDelay=7 7 7 7 7
TimeValue=1 1 1 1 1
DiamondValue=99 0
RandSeed=0 0 0 0 0
ActiveGuyIsFirst=false
AmoebaProperties.immediately=false
MagicWallTime=0 0 0 0 0
MagicWallProperties.convertamoeba=false
SlimePermeabilityC64=0 0 0 0 0
BorderProperties.lineshift=true
BorderProperties.objectwraparound=true
BorderProperties.scan=false

[map]
WWWWWWWWWWWWWWWWWWWWWWWWWWWWWWWWWWWWWWWW
WWWWWWWWWWWWWWWWWWWWWWWWWWWWWWWWWWWWWWWW
WWWWWWWWWWWWWWWWWWWWWWWWWWWWWWWWWWWWWWWW
WWWWWWWWWWWWWWWWWWWWWWWWWWWWWWWWWWWWWWWW
WWWWWWWWWWWWWWWWWWWWWWWWWWWWWWWWWWWWWWWW
WWWWWWWWWWWWWWWWWWWWWWWWWWWWWWWWWWWWWWWW
WWWWWWWWWWWWWWWWWWWWWWWWWWWWWWWWWWWWWWWW
WWWWWWWWWWWWWWWWWWWWWWWWWWWWWWWWWWWWWWWW
WWWWWWWWWWWWWWWWWWWWWWWWWWWWWWWWWWWWWWWW
WWWWWWWWWWWWWWWWWWWWWWWWWWWWWWWWWWWWWWWW
WWWWWWWWWWWWWWWWWWWWWWWWWWWWWWWWWWWWWWWW
WWWWWWWWWWWWWWWWWWWWrrrrrrrrrXrrrrrrrrrW
WWWWWWWWWWWWWWWWWWWWrrrrrrrrrrrrrrrrrrrW
WWWWWWWWWWWWWWWWWWWWrrrrrdrrrdrrrdrrrrrW
WWWWWWWWWWWWWWWWWWWWrrrrrrrrrrrrrrrrrrrW
WWWWWWWWWWWWWWWWWWWWrrrrrrrrrrrrrrrrrrrW
WWWWWWWWWWWWWWWWWWWW.....rr.r.r.rr.....W
WWWWWWWWWWWWWWWWWWWW......rr.r.rr......W
WWWWWWWWWWWWWWWWWWWW.......rr.rr.......W
WWWWWWWWWWWWWWWWWWWW........r.r........W
WWWWWWWWWWWWWWWWWWWW.........P.........W
WWWWWWWWWWWWWWWWWWWWWWWWWWWWWWWWWWWWWWWW
[/map]
[/cave]

[cave]
Name=Cave 05
IntermissionProperties.instantlife=true
Intermission=false
IntermissionProperties.rewardlife=false
Size=40 22 0 0 39 21
Colors=Black Black Blue Gray1 Green Green Green
DiamondsRequired=3 3 3 3 3
CaveTime=100 100 100 100 100
CaveScheduling=plck
PALTiming=true
FrameTime=140 140 140 140 140
CaveDelay=7 7 7 7 7
TimeValue=1 1 1 1 1
DiamondValue=99 0
RandSeed=0 0 0 0 0
ActiveGuyIsFirst=false
AmoebaProperties.immediately=false
AmoebaTime=30 30 30 30 30
MagicWallTime=0 0 0 0 0
MagicWallProperties.convertamoeba=false
SlimePermeabilityC64=0 0 0 0 0
BorderProperties.lineshift=true
BorderProperties.objectwraparound=true
BorderProperties.scan=false

[map]
WWWWWWWWWWWWWWWWWWWWWWWWWWWWWWWWWWWWWWWW
WWWWWWWWWWWWWWWWWWWWWWWWWWWWWWWWWWWWWWWW
WWWWWWWWWWWWWWWWWWWWWWWWWWWWWWWWWWWWWWWW
WWWWWWWWWWWWWWWWWWWWWWWWWWWWWWWWWWWWWWWW
WWWWWWWWWWWWWWWWWWWWWWWWWWWWWWWWWWWWWWWW
WWWWWWWWWWWWWWWWWWWWWWWWWWWWWWWWWWWWWWWW
WWWWWWWWWWWWWWWWWWWWWWWWWWWWWWWWWWWWWWWW
WWWWWWWWWWWWWWWWWWWWWWWWWWWWWWWWWWWWWWWW
WWWWWWWWWWWWWWWWWWWWWWWWWWWWWWWWWWWWWWWW
WWWWWWWWWWWWWWWWWWWWWWWWWWWWWWWWWWWWWWWW
WWWWWWWWWWWWWWWWWWWWWWWWWWWWWWWWWWWWWWWW
WWWWWWWWWWWWWWWWWWWWQQQQQQQ..X..QQQQQQQW
WWWWWWWWWWWWWWWWWWWWQQQQQQr..r..rQQQQQQW
WWWWWWWWWWWWWWWWWWWWQQQQQr...r...rQQQQQW
WWWWWWWWWWWWWWWWWWWWQQQQr....r....rQQQQW
WWWWWWWWWWWWWWWWWWWWQQQr...........rQQQW
WWWWWWWWWWWWWWWWWWWWQQQr...........rQQQW
WWWWWWWWWWWWWWWWWWWWQQQQr....P....rQQQQW
WWWWWWWWWWWWWWWWWWWWQQQQQr.......rQQQQQW
WWWWWWWWWWWWWWWWWWWWQQQQQQr. r .rQQQQQQW
WWWWWWWWWWWWWWWWWWWWQQQQQQQrrarrQQQQQQQW
WWWWWWWWWWWWWWWWWWWWWWWWWWWWWWWWWWWWWWWW
[/map]
[/cave]

[cave]
Name=Cave 06
IntermissionProperties.instantlife=true
Intermission=false
IntermissionProperties.rewardlife=false
Size=40 22 0 0 39 21
Colors=Black Black Gray1 Orange Yellow Yellow Yellow
DiamondsRequired=13 13 13 13 13
CaveTime=120 120 120 120 120
CaveScheduling=plck
PALTiming=true
FrameTime=140 140 140 140 140
CaveDelay=7 7 7 7 7
TimeValue=1 1 1 1 1
DiamondValue=60 0
RandSeed=0 0 0 0 0
ActiveGuyIsFirst=false
AmoebaProperties.immediately=false
MagicWallTime=0 0 0 0 0
MagicWallProperties.convertamoeba=false
SlimePermeabilityC64=0 0 0 0 0
BorderProperties.lineshift=true
BorderProperties.objectwraparound=true
BorderProperties.scan=false

[map]
WWWWWWWWWWWWWWWWWWWWWWWWWWWWWWWWWWWWWWWW
WWWWWWWWWWWWWWWWWWWWWWWWWWWWWWWWWWWWWWWW
WWWWWWWWWWWWWWWWWWWWWWWWWWWWWWWWWWWWWWWW
WWWWWWWWWWWWWWWWWWWWWWWWWWWWWWWWWWWWWWWW
WWWWWWWWWWWWWWWWWWWWWWWWWWWWWWWWWWWWWWWW
WWWWWWWWWWWWWWWWWWWWWWWWWWWWWWWWWWWWWWWW
WWWWWWWWWWWWWWWWWWWWWWWWWWWWWWWWWWWWWWWW
WWWWWWWWWWWWWWWWWWWWWWWWWWWWWWWWWWWWWWWW
WWWWWWWWWWWWWWWWWWWWWWWWWWWWWWWWWWWWWWWW
WWWWWWWWWWWWWWWWWWWWWWWWWWWWWWWWWWWWWWWW
WWWWWWWWWWWWWWWWWWWWWWWWWWWWWWWWWWWWWWWW
WWWWWWWWWWWWWWWWWWWWrdr.rr.rrrr....rrdrW
WWWWWWWWWWWWWWWWWWWWPXr...rrdr.rrrrrrrrW
WWWWWWWWWWWWWWWWWWWW...rrr.rrr...rrrrrrW
WWWWWWWWWWWWWWWWWWWW.r..r.rrrrd..rrrrrrW
WWWWWWWWWWWWWWWWWWWWr..r..rrrrrr..r.drrW
WWWWWWWWWWWWWWWWWWWWd..rd.rrrrrr..rr..rW
WWWWWWWWWWWWWWWWWWWWr.rrrr.rrrr...r.r.rW
WWWWWWWWWWWWWWWWWWWW..rr.r..drrr..d....W
WWWWWWWWWWWWWWWWWWWW.rr.d.r..r....r.r..W
WWWWWWWWWWWWWWWWWWWWd...r......d...rr.dW
WWWWWWWWWWWWWWWWWWWWWWWWWWWWWWWWWWWWWWWW
[/map]
[/cave]

[cave]
Name=Cave 07
IntermissionProperties.instantlife=true
Intermission=false
IntermissionProperties.rewardlife=false
Size=40 22 0 0 39 21
Colors=Black Black Black Purple Yellow Yellow Yellow
DiamondsRequired=27 27 27 27 27
CaveTime=120 120 120 120 120
CaveScheduling=plck
PALTiming=true
FrameTime=140 140 140 140 140
CaveDelay=7 7 7 7 7
TimeValue=1 1 1 1 1
DiamondValue=20 0
RandSeed=0 0 0 0 0
ActiveGuyIsFirst=false
AmoebaProperties.immediately=false
MagicWallTime=0 0 0 0 0
MagicWallProperties.convertamoeba=false
SlimePermeabilityC64=0 0 0 0 0
BorderProperties.lineshift=true
BorderProperties.objectwraparound=true
BorderProperties.scan=false

[map]
WWWWWWWWWWWWWWWWWWWWWWWWWWWWWWWWWWWWWWWW
WWWWWWWWWWWWWWWWWWWWWWWWWWWWWWWWWWWWWWWW
WWWWWWWWWWWWWWWWWWWWWWWWWWWWWWWWWWWWWWWW
WWWWWWWWWWWWWWWWWWWWWWWWWWWWWWWWWWWWWWWW
WWWWWWWWWWWWWWWWWWWWWWWWWWWWWWWWWWWWWWWW
WWWWWWWWWWWWWWWWWWWWWWWWWWWWWWWWWWWWWWWW
WWWWWWWWWWWWWWWWWWWWWWWWWWWWWWWWWWWWWWWW
WWWWWWWWWWWWWWWWWWWWWWWWWWWWWWWWWWWWWWWW
WWWWWWWWWWWWWWWWWWWWWWWWWWWWWWWWWWWWWWWW
WWWWWWWWWWWWWWWWWWWWWWWWWWWWWWWWWWWWWWWW
WWWWWWWWWWWWWWWWWWWWWWWWWWWWWWWWWWWWWWWW
WWWWWWWWWWWWWWWWWWWW         W         W
WWWWWWWWWWWWWWWWWWWW dW  WdWdXdWdW  Wd W
WWWWWWWWWWWWWWWWWWWW WW  WWWWWWWWW  WW W
WWWWWWWWWWWWWWWWWWWW         PQQQQ     W
WWWWWWWWWWWWWWWWWWWW     WWW W WWW     W
WWWWWWWWWWWWWWWWWWWW     WdddWdddW     W
WWWWWWWWWWWWWWWWWWWW     WWWWWWWWW     W
WWWWWWWWWWWWWWWWWWWW                   W
WWWWWWWWWWWWWWWWWWWWWQWWWQWWWQWWWQWWWQWW
WWWWWWWWWWWWWWWWWWWWdddWdddWdddWdddWdddW
WWWWWWWWWWWWWWWWWWWWWWWWWWWWWWWWWWWWWWWW
[/map]
[/cave]

[cave]
Name=Cave 08
IntermissionProperties.instantlife=true
Intermission=false
IntermissionProperties.rewardlife=false
Size=40 22 0 0 39 21
Colors=Black Black Brown Blue Green Green Green
DiamondsRequired=99 99 99 99 99
CaveTime=222 222 222 222 222
CaveScheduling=plck
PALTiming=true
FrameTime=140 140 140 140 140
CaveDelay=7 7 7 7 7
TimeValue=1 1 1 1 1
DiamondValue=5 0
RandSeed=0 0 0 0 0
ActiveGuyIsFirst=false
AmoebaProperties.immediately=false
AmoebaTime=90 90 90 90 90
MagicWallTime=0 0 0 0 0
MagicWallProperties.convertamoeba=false
SlimePermeabilityC64=0 0 0 0 0
BorderProperties.lineshift=true
BorderProperties.objectwraparound=true
BorderProperties.scan=false

[map]
WWWWWWWWWWWWWWWWWWWWWWWWWWWWWWWWWWWWWWWW
WWWWWWWWWWWWWWWWWWWWWWWWWWWWWWWWWWWWWWWW
WWWWWWWWWWWWWWWWWWWWWWWWWWWWWWWWWWWWWWWW
WWWWWWWWWWWWWWWWWWWWWWWWWWWWWWWWWWWWWWWW
WWWWWWWWWWWWWWWWWWWWWWWWWWWWWWWWWWWWWWWW
WWWWWWWWWWWWWWWWWWWWWWWWWWWWWWWWWWWWWWWW
WWWWWWWWWWWWWWWWWWWWWWWWWWWWWWWWWWWWWWWW
WWWWWWWWWWWWWWWWWWWWWWWWWWWWWWWWWWWWWWWW
WWWWWWWWWWWWWWWWWWWWWWWWWWWWWWWWWWWWWWWW
WWWWWWWWWWWWWWWWWWWWWWWWWWWWWWWWWWWWWWWW
WWWWWWWWWWWWWWWWWWWWWWWWWWWWWWWWWWWWWXWW
WWWWWWWWWWWWWWWWWWWWwcccwr...a...rwQQQwW
WWWWWWWWWWWWWWWWWWWWwcwcwrr.....rrwQwQwW
WWWWWWWWWWWWWWWWWWWWwcwcwrrr...rrrwQwQwW
WWWWWWWWWWWWWWWWWWWWwcwcwrrrrrrrrrwQwQwW
WWWWWWWWWWWWWWWWWWWWwcwcrrrrrrrrrrrQwQwW
WWWWWWWWWWWWWWWWWWWWwcwcw.........wQwQwW
WWWWWWWWWWWWWWWWWWWWwcwcw.........wQwQwW
WWWWWWWWWWWWWWWWWWWWwcwcw.........wQwQwW
WWWWWWWWWWWWWWWWWWWWwcwcw.........wQwQwW
WWWWWWWWWWWWWWWWWWWWwcccw....P....wQQQwW
WWWWWWWWWWWWWWWWWWWWWWWWWWWWWWWWWWWWWWWW
[/map]
[/cave]

[cave]
Name=Cave 09
IntermissionProperties.instantlife=true
Intermission=false
IntermissionProperties.rewardlife=false
Size=40 22 0 0 39 21
Colors=Black Black Gray2 Green Yellow Yellow Yellow
DiamondsRequired=51 51 51 51 51
CaveTime=222 222 222 222 222
CaveScheduling=plck
PALTiming=true
FrameTime=140 140 140 140 140
CaveDelay=7 7 7 7 7
TimeValue=1 1 1 1 1
DiamondValue=10 0
RandSeed=0 0 0 0 0
ActiveGuyIsFirst=false
AmoebaProperties.immediately=false
MagicWallTime=0 0 0 0 0
MagicWallProperties.convertamoeba=false
SlimePermeabilityC64=0 0 0 0 0
BorderProperties.lineshift=true
BorderProperties.objectwraparound=true
BorderProperties.scan=false

[map]
WWWWWWWWWWWWWWWWWWWWWWWWWWWWWWWWWWWWWWWW
WWWWWWWWWWWWWWWWWWWWWWWWWWWWWWWWWWWWWWWW
WWWWWWWWWWWWWWWWWWWWWWWWWWWWWWWWWWWWWWWW
WWWWWWWWWWWWWWWWWWWWWWWWWWWWWWWWWWWWWWWW
WWWWWWWWWWWWWWWWWWWWWWWWWWWWWWWWWWWWWWWW
WWWWWWWWWWWWWWWWWWWWWWWWWWWWWWWWWWWWWWWW
WWWWWWWWWWWWWWWWWWWWWWWWWWWWWWWWWWWWWWWW
WWWWWWWWWWWWWWWWWWWWWWWWWWWWWWWWWWWWWWWW
WWWWWWWWWWWWWWWWWWWWWWWWWWWWWWWWWWWWWWWW
WWWWWWWWWWWWWWWWWWWWWWWWWWWWWWWWWWWWWWWW
WWWWWWWWWWWWWWWWWWWWWWWWWWWWWWWWWWWWWXWW
WWWWWWWWWWWWWWWWWWWW  ..r....r....r..  W
WWWWWWWWWWWWWWWWWWWWc.................cW
WWWWWWWWWWWWWWWWWWWW...................W
WWWWWWWWWWWWWWWWWWWW ................. W
WWWWWWWWWWWWWWWWWWWW ................. W
WWWWWWWWWWWWWWWWWWWW ................. W
WWWWWWWWWWWWWWWWWWWWc.................cW
WWWWWWWWWWWWWWWWWWWW...................W
WWWWWWWWWWWWWWWWWWWW ................. W
WWWWWWWWWWWWWWWWWWWW c.......P.......c W
WWWWWWWWWWWWWWWWWWWWWWWWWWWWWWWWWWWWWWWW
[/map]
[/cave]

[cave]
Name=Cave 10
IntermissionProperties.instantlife=true
Intermission=false
IntermissionProperties.rewardlife=false
Size=40 22 0 0 39 21
Colors=Black Black Blue Red Purple Purple Purple
DiamondsRequired=50 50 50 50 50
CaveTime=222 222 222 222 222
CaveScheduling=plck
PALTiming=true
FrameTime=140 140 140 140 140
CaveDelay=7 7 7 7 7
TimeValue=1 1 1 1 1
DiamondValue=10 0
RandSeed=0 0 0 0 0
ActiveGuyIsFirst=false
AmoebaProperties.immediately=false
AmoebaTime=100 100 100 100 100
MagicWallTime=0 0 0 0 0
MagicWallProperties.convertamoeba=false
SlimePermeabilityC64=0 0 0 0 0
BorderProperties.lineshift=true
BorderProperties.objectwraparound=true
BorderProperties.scan=false

[map]
WWWWWWWWWWWWWWWWWWWWWWWWWWWWWWWWWWWWWWWW
WWWWWWWWWWWWWWWWWWWWWWWWWWWWWWWWWWWWWWWW
WWWWWWWWWWWWWWWWWWWWWWWWWWWWWWWWWWWWWWWW
WWWWWWWWWWWWWWWWWWWWWWWWWWWWWWWWWWWWWWWW
WWWWWWWWWWWWWWWWWWWWWWWWWWWWWWWWWWWWWWWW
WWWWWWWWWWWWWWWWWWWWWWWWWWWWWWWWWWWWWWWW
WWWWWWWWWWWWWWWWWWWWWWWWWWWWWWWWWWWWWWWW
WWWWWWWWWWWWWWWWWWWWWWWWWWWWWWWWWWWWWWWW
WWWWWWWWWWWWWWWWWWWWWWWWWWWWWWWWWWWWWWWW
WWWWWWWWWWWWWWWWWWWWWWWWWWWWWWWWWWWWWWWW
WWWWWWWWWWWWWWWWWWWWWWWWWWWWWXWWWWWWWWWW
WWWWWWWWWWWWWWWWWWWWQrrrrrrrrrrrrrrrrrQW
WWWWWWWWWWWWWWWWWWWWr.................rW
WWWWWWWWWWWWWWWWWWWWrFP..............FrW
WWWWWWWWWWWWWWWWWWWWr.................rW
WWWWWWWWWWWWWWWWWWWWQ.................QW
WWWWWWWWWWWWWWWWWWWWr.................rW
WWWWWWWWWWWWWWWWWWWWr.................rW
WWWWWWWWWWWWWWWWWWWWr.................rW
WWWWWWWWWWWWWWWWWWWWr.................rW
WWWWWWWWWWWWWWWWWWWWQ........a........QW
WWWWWWWWWWWWWWWWWWWWWWWWWWWWWWWWWWWWWWWW
[/map]
[/cave]

[cave]
Name=Cave 11
IntermissionProperties.instantlife=true
Intermission=false
IntermissionProperties.rewardlife=false
Size=40 22 0 0 39 21
Colors=Black Black Yellow Blue Blue Blue Blue
DiamondsRequired=91 91 91 91 91
CaveTime=120 120 120 120 120
CaveScheduling=plck
PALTiming=true
FrameTime=140 140 140 140 140
CaveDelay=7 7 7 7 7
TimeValue=1 1 1 1 1
DiamondValue=10 0
RandSeed=0 0 0 0 0
ActiveGuyIsFirst=false
AmoebaProperties.immediately=false
MagicWallTime=0 0 0 0 0
MagicWallProperties.convertamoeba=false
SlimePermeabilityC64=0 0 0 0 0
BorderProperties.lineshift=true
BorderProperties.objectwraparound=true
BorderProperties.scan=false

[map]
WWWWWWWWWWWWWWWWWWWWWWWWWWWWWWWWWWWWWWWW
WWWWWWWWWWWWWWWWWWWWWWWWWWWWWWWWWWWWWWWW
WWWWWWWWWWWWWWWWWWWWWWWWWWWWWWWWWWWWWWWW
WWWWWWWWWWWWWWWWWWWWWWWWWWWWWWWWWWWWWWWW
WWWWWWWWWWWWWWWWWWWWWWWWWWWWWWWWWWWWWWWW
WWWWWWWWWWWWWWWWWWWWWWWWWWWWWWWWWWWWWWWW
WWWWWWWWWWWWWWWWWWWWWWWWWWWWWWWWWWWWWWWW
WWWWWWWWWWWWWWWWWWWWWWWWWWWWWWWWWWWWWWWW
WWWWWWWWWWWWWWWWWWWWWWWWWWWWWWWWWWWWWWWW
WWWWWWWWWWWWWWWWWWWWWWWWWWWWWWWWWWWWWWWW
WWWWWWWWWWWWWWWWWWWWWWWWWWWWWWWWWWWWWWWW
WWWWWWWWWWWWWWWWWWWWxdd.  ..dxd..  .ddxW
WWWWWWWWWWWWWWWWWWWWddx.xddx.x.xddx.xddW
WWWWWWWWWWWWWWWWWWWWddx.xddx.x.xddx.xddW
WWWWWWWWWWWWWWWWWWWWddxdxddx.x.xddxdxddW
WWWWWWWWWWWWWWWWWWWWddx.xddxdPdxddx.xddW
WWWWWWWWWWWWWWWWWWWWddx.xddxxxxxddx.xddW
WWWWWWWWWWWWWWWWWWWWddx.xdddd.ddddx.xddW
WWWWWWWWWWWWWWWWWWWWddx.x.dddxddd.x.xddW
WWWWWWWWWWWWWWWWWWWWddx...dddxddd...xddW
WWWWWWWWWWWWWWWWWWWWx....ddddXdddd...dxW
WWWWWWWWWWWWWWWWWWWWWWWWWWWWWWWWWWWWWWWW
[/map]
[/cave]

[cave]
Name=Cave 12
IntermissionProperties.instantlife=true
Intermission=false
IntermissionProperties.rewardlife=false
Size=40 22 0 0 39 21
Colors=Black Black Orange Gray3 White White White
DiamondsRequired=50 50 50 50 50
CaveTime=120 120 120 120 120
CaveScheduling=plck
PALTiming=true
FrameTime=140 140 140 140 140
CaveDelay=7 7 7 7 7
TimeValue=1 1 1 1 1
DiamondValue=10 0
RandSeed=0 0 0 0 0
ActiveGuyIsFirst=false
AmoebaProperties.immediately=false
MagicWallTime=0 0 0 0 0
MagicWallProperties.convertamoeba=false
SlimePermeabilityC64=0 0 0 0 0
BorderProperties.lineshift=true
BorderProperties.objectwraparound=true
BorderProperties.scan=false

[map]
WWWWWWWWWWWWWWWWWWWWWWWWWWWWWWWWWWWWWWWW
WWWWWWWWWWWWWWWWWWWWWWWWWWWWWWWWWWWWWWWW
WWWWWWWWWWWWWWWWWWWWWWWWWWWWWWWWWWWWWWWW
WWWWWWWWWWWWWWWWWWWWWWWWWWWWWWWWWWWWWWWW
WWWWWWWWWWWWWWWWWWWWWWWWWWWWWWWWWWWWWWWW
WWWWWWWWWWWWWWWWWWWWWWWWWWWWWWWWWWWWWWWW
WWWWWWWWWWWWWWWWWWWWWWWWWWWWWWWWWWWWWWWW
WWWWWWWWWWWWWWWWWWWWWWWWWWWWWWWWWWWWWWWW
WWWWWWWWWWWWWWWWWWWWWWWWWWWWWWWWWWWWWWWW
WWWWWWWWWWWWWWWWWWWWWWWWWWWWWWWWWWWWWWWW
WWWWWWWWWWWWWWWWWWWWWWWWWWWWWXWWWWWWWWWW
WWWWWWWWWWWWWWWWWWWWwrrrddrdrddrdrrdddwW
WWWWWWWWWWWWWWWWWWWWwwddrdrdddrdrdrdrwwW
WWWWWWWWWWWWWWWWWWWWwwwddddrdrdrddddwwwW
WWWWWWWWWWWWWWWWWWWWwwwwrrdddddddrdwwwwW
WWWWWWWWWWWWWWWWWWWWwwwwwrrrddrdrdwwwwwW
WWWWWWWWWWWWWWWWWWWWwwwwwwrrrddddwwwwwwW
WWWWWWWWWWWWWWWWWWWWwwwwwwwrddrdwwwwwwwW
WWWWWWWWWWWWWWWWWWWWwwwwwwwwdddwwwwwwwwW
WWWWWWWWWWWWWWWWWWWWwwwwwwwww.wwwwwwwwwW
WWWWWWWWWWWWWWWWWWWWwwwwwwwwwPwwwwwwwwwW
WWWWWWWWWWWWWWWWWWWWWWWWWWWWWWWWWWWWWWWW
[/map]
[/cave]

[cave]
Name=Cave 13
IntermissionProperties.instantlife=true
Intermission=false
IntermissionProperties.rewardlife=false
Size=40 22 0 0 39 21
Colors=Black Black LightRed Purple Cyan Cyan Cyan
DiamondsRequired=10 10 10 10 10
CaveTime=120 120 120 120 120
CaveScheduling=plck
PALTiming=true
FrameTime=140 140 140 140 140
CaveDelay=7 7 7 7 7
TimeValue=1 1 1 1 1
DiamondValue=10 0
RandSeed=0 0 0 0 0
ActiveGuyIsFirst=false
AmoebaProperties.immediately=false
MagicWallTime=0 0 0 0 0
MagicWallProperties.convertamoeba=false
SlimePermeabilityC64=0 0 0 0 0
BorderProperties.lineshift=true
BorderProperties.objectwraparound=true
BorderProperties.scan=false

[map]
WWWWWWWWWWWWWWWWWWWWWWWWWWWWWWWWWWWWWWWW
WWWWWWWWWWWWWWWWWWWWWWWWWWWWWWWWWWWWWWWW
WWWWWWWWWWWWWWWWWWWWWWWWWWWWWWWWWWWWWWWW
WWWWWWWWWWWWWWWWWWWWWWWWWWWWWWWWWWWWWWWW
WWWWWWWWWWWWWWWWWWWWWWWWWWWWWWWWWWWWWWWW
WWWWWWWWWWWWWWWWWWWWWWWWWWWWWWWWWWWWWWWW
WWWWWWWWWWWWWWWWWWWWWWWWWWWWWWWWWWWWWWWW
WWWWWWWWWWWWWWWWWWWWWWWWWWWWWWWWWWWWWWWW
WWWWWWWWWWWWWWWWWWWWWWWWWWWWWWWWWWWWWWWW
WWWWWWWWWWWWWWWWWWWWWWWWWWWWWWWWWWWWWWWW
WWWWWWWWWWWWWWWWWWWWWWWWWWWWWXWWWWWWWWWW
WWWWWWWWWWWWWWWWWWWWdW.r.........Q.Q.Q.W
WWWWWWWWWWWWWWWWWWWWdW.........F.r.r.r.W
WWWWWWWWWWWWWWWWWWWWdW.r....... .......W
WWWWWWWWWWWWWWWWWWWWdW...rrr... . . . .W
WWWWWWWWWWWWWWWWWWWWdwwr.rrr... . . . .W
WWWWWWWWWWWWWWWWWWWWdww..rrr... . . . .W
WWWWWWWWWWWWWWWWWWWWdww..rrr... . . . .W
WWWWWWWWWWWWWWWWWWWWdww..rrr... . . . .W
WWWWWWWWWWWWWWWWWWWWdww........ . . . .W
WWWWWWWWWWWWWWWWWWWWdww........P.F.F.F.W
WWWWWWWWWWWWWWWWWWWWWWWWWWWWWWWWWWWWWWWW
[/map]
[/cave]

[cave]
Name=Cave 14
IntermissionProperties.instantlife=true
Intermission=false
IntermissionProperties.rewardlife=false
Size=40 22 0 0 39 21
Colors=Black Black Blue Green White White White
DiamondsRequired=94 94 94 94 94
CaveTime=120 120 120 120 120
CaveScheduling=plck
PALTiming=true
FrameTime=140 140 140 140 140
CaveDelay=7 7 7 7 7
TimeValue=1 1 1 1 1
DiamondValue=5 0
RandSeed=0 0 0 0 0
ActiveGuyIsFirst=false
AmoebaProperties.immediately=false
MagicWallTime=0 0 0 0 0
MagicWallProperties.convertamoeba=false
SlimePermeabilityC64=0 0 0 0 0
BorderProperties.lineshift=true
BorderProperties.objectwraparound=true
BorderProperties.scan=false

[map]
WWWWWWWWWWWWWWWWWWWWWWWWWWWWWWWWWWWWWWWW
WWWWWWWWWWWWWWWWWWWWWWWWWWWWWWWWWWWWWWWW
WWWWWWWWWWWWWWWWWWWWWWWWWWWWWWWWWWWWWWWW
WWWWWWWWWWWWWWWWWWWWWWWWWWWWWWWWWWWWWWWW
WWWWWWWWWWWWWWWWWWWWWWWWWWWWWWWWWWWWWWWW
WWWWWWWWWWWWWWWWWWWWWWWWWWWWWWWWWWWWWWWW
WWWWWWWWWWWWWWWWWWWWWWWWWWWWWWWWWWWWWWWW
WWWWWWWWWWWWWWWWWWWWWWWWWWWWWWWWWWWWWWWW
WWWWWWWWWWWWWWWWWWWWWWWWWWWWWWWWWWWWWWWW
WWWWWWWWWWWWWWWWWWWWWWWWWWWWWWWWWWWWWWWW
WWWWWWWWWWWWWWWWWWWWWWWWWWWWWXWWWWWWWWWW
WWWWWWWWWWWWWWWWWWWWrrrrrrrrrrrrrrrrrrrW
WWWWWWWWWWWWWWWWWWWWrrrrrrrrrrrrrrrrrrrW
WWWWWWWWWWWWWWWWWWWWrrrrrrrrrrrrrrrrrrrW
WWWWWWWWWWWWWWWWWWWWrrrrrrrrrrrrrrrrrrrW
WWWWWWWWWWWWWWWWWWWWrrrrrrrrrrrrrrrrrrrW
WWWWWWWWWWWWWWWWWWWWdddddddddddddddddddW
WWWWWWWWWWWWWWWWWWWWdddddddddddddddddddW
WWWWWWWWWWWWWWWWWWWWdddddddddddddddddddW
WWWWWWWWWWWWWWWWWWWWdddddddddddddddddddW
WWWWWWWWWWWWWWWWWWWWdddddddddPdddddddddW
WWWWWWWWWWWWWWWWWWWWWWWWWWWWWWWWWWWWWWWW
[/map]
[/cave]

[cave]
Name=Cave 15
IntermissionProperties.instantlife=true
Intermission=false
IntermissionProperties.rewardlife=false
Size=40 22 0 0 39 21
Colors=Black Black Gray1 Blue Cyan Cyan Cyan
DiamondsRequired=18 18 18 18 18
CaveTime=120 120 120 120 120
CaveScheduling=plck
PALTiming=true
FrameTime=140 140 140 140 140
CaveDelay=7 7 7 7 7
TimeValue=1 1 1 1 1
DiamondValue=30 0
RandSeed=0 0 0 0 0
ActiveGuyIsFirst=false
AmoebaProperties.immediately=false
MagicWallTime=0 0 0 0 0
MagicWallProperties.convertamoeba=false
SlimePermeabilityC64=0 0 0 0 0
BorderProperties.lineshift=true
BorderProperties.objectwraparound=true
BorderProperties.scan=false

[map]
WWWWWWWWWWWWWWWWWWWWWWWWWWWWWWWWWWWWWWWW
WWWWWWWWWWWWWWWWWWWWWWWWWWWWWWWWWWWWWWWW
WWWWWWWWWWWWWWWWWWWWWWWWWWWWWWWWWWWWWWWW
WWWWWWWWWWWWWWWWWWWWWWWWWWWWWWWWWWWWWWWW
WWWWWWWWWWWWWWWWWWWWWWWWWWWWWWWWWWWWWWWW
WWWWWWWWWWWWWWWWWWWWWWWWWWWWWWWWWWWWWWWW
WWWWWWWWWWWWWWWWWWWWWWWWWWWWWWWWWWWWWWWW
WWWWWWWWWWWWWWWWWWWWWWWWWWWWWWWWWWWWWWWW
WWWWWWWWWWWWWWWWWWWWWWWWWWWWWWWWWWWWWWWW
WWWWWWWWWWWWWWWWWWWWWWWWWWWWWWWWWWWWWWWW
WWWWWWWWWWWWWWWWWWWWWWWWWWWWWXWWWWWWWWWW
WWWWWWWWWWWWWWWWWWWW.r...............r.W
WWWWWWWWWWWWWWWWWWWW.......r...r.......W
WWWWWWWWWWWWWWWWWWWW......rr.Q.rr......W
WWWWWWWWWWWWWWWWWWWW.....rcr.Q.rcr.....W
WWWWWWWWWWWWWWWWWWWW....rrrr.Q.rrrr....W
WWWWWWWWWWWWWWWWWWWW...rrrQr.Q.rQrrr...W
WWWWWWWWWWWWWWWWWWWW..rrrQQr.Q.rQQrrr..W
WWWWWWWWWWWWWWWWWWWW.rrrrrrr.Q.rrrrrrr.W
WWWWWWWWWWWWWWWWWWWW...................W
WWWWWWWWWWWWWWWWWWWW.........P.........W
WWWWWWWWWWWWWWWWWWWWWWWWWWWWWWWWWWWWWWWW
[/map]
[/cave]

[cave]
Name=Cave 16
IntermissionProperties.instantlife=true
Intermission=false
IntermissionProperties.rewardlife=false
Size=40 22 0 0 39 21
Colors=Black Black LightBlue Orange Yellow Yellow Yellow
DiamondsRequired=11 11 11 11 11
CaveTime=200 200 200 200 200
CaveScheduling=plck
PALTiming=true
FrameTime=140 140 140 140 140
CaveDelay=7 7 7 7 7
TimeValue=1 1 1 1 1
DiamondValue=50 0
RandSeed=0 0 0 0 0
ActiveGuyIsFirst=false
AmoebaProperties.immediately=false
MagicWallTime=0 0 0 0 0
MagicWallProperties.convertamoeba=false
SlimePermeabilityC64=254 254 254 254 254
BorderProperties.lineshift=true
BorderProperties.objectwraparound=true
BorderProperties.scan=false

[map]
WWWWWWWWWWWWWWWWWWWWWWWWWWWWWWWWWWWWWWWW
WWWWWWWWWWWWWWWWWWWWWWWWWWWWWWWWWWWWWWWW
WWWWWWWWWWWWWWWWWWWWWWWWWWWWWWWWWWWWWWWW
WWWWWWWWWWWWWWWWWWWWWWWWWWWWWWWWWWWWWWWW
WWWWWWWWWWWWWWWWWWWWWWWWWWWWWWWWWWWWWWWW
WWWWWWWWWWWWWWWWWWWWWWWWWWWWWWWWWWWWWWWW
WWWWWWWWWWWWWWWWWWWWWWWWWWWWWWWWWWWWWWWW
WWWWWWWWWWWWWWWWWWWWWWWWWWWWWWWWWWWWWWWW
WWWWWWWWWWWWWWWWWWWWWWWWWWWWWWWWWWWWWWWW
WWWWWWWWWWWWWWWWWWWWWWWWWWWWWWWWWWWWWWWW
WWWWWWWWWWWWWWWWWWWWWWWWWWWWWWWWWWWWWWWW
WWWWWWWWWWWWWWWWWWWWQ..rrrrrrrrrrrrr..QW
WWWWWWWWWWWWWWWWWWWW...................W
WWWWWWWWWWWWWWWWWWWW...wsssssssssssw...W
WWWWWWWWWWWWWWWWWWWW...w           w...W
WWWWWWWWWWWWWWWWWWWW...wMMMMMMMMMMMw...W
WWWWWWWWWWWWWWWWWWWW ..w           w.. W
WWWWWWWWWWWWWWWWWWWW ..wsssssXsssssw.. W
WWWWWWWWWWWWWWWWWWWW ..w           w.. W
WWWWWWWWWWWWWWWWWWWW ..wMMMMMMMMMMMw.. W
WWWWWWWWWWWWWWWWWWWWQ........P........QW
WWWWWWWWWWWWWWWWWWWWWWWWWWWWWWWWWWWWWWWW
[/map]
[/cave]

[cave]
Name=Cave 17
IntermissionProperties.instantlife=true
Intermission=false
IntermissionProperties.rewardlife=false
Size=40 22 0 0 39 21
Colors=Black Black LightBlue Brown Yellow Yellow Yellow
DiamondsRequired=70 70 70 70 70
CaveTime=100 100 100 100 100
CaveScheduling=plck
PALTiming=true
FrameTime=140 140 140 140 140
CaveDelay=7 7 7 7 7
TimeValue=1 1 1 1 1
DiamondValue=10 0
RandSeed=0 0 0 0 0
ActiveGuyIsFirst=false
AmoebaProperties.immediately=false
AmoebaTime=1 1 1 1 1
MagicWallTime=0 0 0 0 0
MagicWallProperties.convertamoeba=false
SlimePermeabilityC64=0 0 0 0 0
BorderProperties.lineshift=true
BorderProperties.objectwraparound=true
BorderProperties.scan=false

[map]
WWWWWWWWWWWWWWWWWWWWWWWWWWWWWWWWWWWWWWWW
WWWWWWWWWWWWWWWWWWWWWWWWWWWWWWWWWWWWWWWW
WWWWWWWWWWWWWWWWWWWWWWWWWWWWWWWWWWWWWWWW
WWWWWWWWWWWWWWWWWWWWWWWWWWWWWWWWWWWWWWWW
WWWWWWWWWWWWWWWWWWWWWWWWWWWWWWWWWWWWWWWW
WWWWWWWWWWWWWWWWWWWWWWWWWWWWWWWWWWWWWWWW
WWWWWWWWWWWWWWWWWWWWWWWWWWWWWWWWWWWWWWWW
WWWWWWWWWWWWWWWWWWWWWWWWWWWWWWWWWWWWWWWW
WWWWWWWWWWWWWWWWWWWWWWWWWWWWWWWWWWWWWWWW
WWWWWWWWWWWWWWWWWWWWWWWWWWWWWWWWWWWWWWWW
WWWWWWWWWWWWWWWWWWWWWWWWWWWWWWWWWWWWWWWW
WWWWWWWWWWWWWWWWWWWWXrrrrrrrrrrrrrrrrrrW
WWWWWWWWWWWWWWWWWWWWrrrrrrrrrrrrrrrrrrrW
WWWWWWWWWWWWWWWWWWWWrrrrrrrrrrrrrrrrrrrW
WWWWWWWWWWWWWWWWWWWWrrrrrrrrrrrrrrrrrrrW
WWWWWWWWWWWWWWWWWWWWrrrrrrrrrrrrrrrrrrrW
WWWWWWWWWWWWWWWWWWWWrrrrrr.......rrrrrrW
WWWWWWWWWWWWWWWWWWWWrrrr...........rrrrW
WWWWWWWWWWWWWWWWWWWWrr.......a.......rrW
WWWWWWWWWWWWWWWWWWWW...................W
WWWWWWWWWWWWWWWWWWWW.........P.........W
WWWWWWWWWWWWWWWWWWWWWWWWWWWWWWWWWWWWWWWW
[/map]
[/cave]

[cave]
Name=Cave 18
IntermissionProperties.instantlife=true
Intermission=false
IntermissionProperties.rewardlife=false
Size=40 22 0 0 39 21
Colors=Black Black Blue Orange Red Red Red
DiamondsRequired=52 52 52 52 52
CaveTime=220 220 220 220 220
CaveScheduling=plck
PALTiming=true
FrameTime=140 140 140 140 140
CaveDelay=7 7 7 7 7
TimeValue=1 1 1 1 1
DiamondValue=10 0
RandSeed=0 0 0 0 0
ActiveGuyIsFirst=false
AmoebaProperties.immediately=false
MagicWallTime=0 0 0 0 0
MagicWallProperties.convertamoeba=false
SlimePermeabilityC64=0 0 0 0 0
BorderProperties.lineshift=true
BorderProperties.objectwraparound=true
BorderProperties.scan=false

[map]
WWWWWWWWWWWWWWWWWWWWWWWWWWWWWWWWWWWWWWWW
WWWWWWWWWWWWWWWWWWWWWWWWWWWWWWWWWWWWWWWW
WWWWWWWWWWWWWWWWWWWWWWWWWWWWWWWWWWWWWWWW
WWWWWWWWWWWWWWWWWWWWWWWWWWWWWWWWWWWWWWWW
WWWWWWWWWWWWWWWWWWWWWWWWWWWWWWWWWWWWWWWW
WWWWWWWWWWWWWWWWWWWWWWWWWWWWWWWWWWWWWWWW
WWWWWWWWWWWWWWWWWWWWWWWWWWWWWWWWWWWWWWWW
WWWWWWWWWWWWWWWWWWWWWWWWWWWWWWWWWWWWWWWW
WWWWWWWWWWWWWWWWWWWWWWWWWWWWWWWWWWWWWWWW
WWWWWWWWWWWWWWWWWWWWWWWWWWWWWWWWWWWWWWWW
WWWWWWWWWWWWWWWWWWWWWWWWWWWWWXWWWWWWWWWW
WWWWWWWWWWWWWWWWWWWWQddddddddQddddddddQW
WWWWWWWWWWWWWWWWWWWWdrrrrrrrrdrrrrrrrrdW
WWWWWWWWWWWWWWWWWWWWdrrrrrrrd.drrrrrrrdW
WWWWWWWWWWWWWWWWWWWWdrrrrrrd...drrrrrrdW
WWWWWWWWWWWWWWWWWWWWdrrrrrd.....drrrrrdW
WWWWWWWWWWWWWWWWWWWWdrrrrd.......drrrrdW
WWWWWWWWWWWWWWWWWWWWdrrrd.........drrrdW
WWWWWWWWWWWWWWWWWWWWdrrd...........drrdW
WWWWWWWWWWWWWWWWWWWWdrd.............dddW
WWWWWWWWWWWWWWWWWWWWdd.......P.......ddW
WWWWWWWWWWWWWWWWWWWWWWWWWWWWWWWWWWWWWWWW
[/map]
[/cave]
[/game]
[/BDCFF]
