[BDCFF]
Version=0.5

[game]
Name=Boulderdash X
Levels=5

[cave]
Name=Cave A
IntermissionProperties.instantlife=true
Intermission=false
IntermissionProperties.rewardlife=false
Size=40 22 0 0 39 21
Colors=Black Black Blue Purple White White White
DiamondsRequired=85 85 85 85 85
CaveTime=100 90 85 80 80
CaveScheduling=bd1
PALTiming=true
FrameTime=180 160 140 120 120
CaveDelay=12 6 3 1 0
DiamondValue=10 20
RandSeed=10 11 12 13 14
RandomFill=SPACE 0 SPACE 0 SPACE 0 SPACE 0
ActiveGuyIsFirst=false
AmoebaTime=20 20 20 20 20
MagicWallTime=20 20 20 20 20
MagicWallProperties.convertamoeba=false
MagicWallProperties.breakscan=true
SlimePermeabilityC64=0 0 0 0 0
Effect=ACIDEffect ACID
AcidProperties=SPACE 0.8314
BorderProperties.lineshift=true
BorderProperties.objectwraparound=true

[objects]
Point=18 19 AMOEBA
Rectangle=7 11 29 12 BOULDER
Point=3 3 INBOX
Point=36 3 OUTBOX
[/objects]
[/cave]

[cave]
Name=Cave B
Selectable=false
IntermissionProperties.instantlife=true
Intermission=false
IntermissionProperties.rewardlife=false
Size=40 22 0 0 39 21
Colors=Black Black LightRed LightGreen White White White
DiamondsRequired=15 15 15 15 15
CaveTime=200 190 190 190 190
CaveScheduling=bd1
PALTiming=true
FrameTime=180 160 140 120 120
CaveDelay=12 6 3 1 0
DiamondValue=20 0
RandSeed=3 0 1 87 88
RandomFill=SPACE 0 BOULDER 50 DIAMOND 10 SPACE 0
ActiveGuyIsFirst=false
AmoebaTime=20 20 20 20 20
MagicWallTime=20 20 20 20 20
MagicWallProperties.convertamoeba=false
MagicWallProperties.breakscan=true
SlimePermeabilityC64=0 0 0 0 0
Effect=ACIDEffect ACID
AcidProperties=SPACE 0.0000
BorderProperties.lineshift=true
BorderProperties.objectwraparound=true

[objects]
Line=1 6 38 6 WALL
Line=1 14 38 14 WALL
Line=10 1 10 20 WALL
Line=20 1 20 20 WALL
Line=30 1 30 20 WALL
Line=4 1 1 4 FIREFLYl
Point=12 1 FIREFLYl
Point=22 1 FIREFLYl
Line=34 1 36 3 FIREFLYl
Point=2 8 FIREFLYl
Point=12 8 FIREFLYl
Point=22 8 FIREFLYl
Point=4 4 INBOX
Point=35 16 OUTBOX
[/objects]
[/cave]

[cave]
Name=Cave C
Selectable=false
IntermissionProperties.instantlife=true
Intermission=false
IntermissionProperties.rewardlife=false
Size=40 22 0 0 39 21
Colors=Black Black Blue LightBlue White White White
DiamondsRequired=70 70 70 70 70
CaveTime=150 100 90 80 70
CaveScheduling=bd1
PALTiming=true
FrameTime=180 160 140 120 120
CaveDelay=12 6 3 1 0
DiamondValue=5 1
RandSeed=0 50 54 52 55
RandomFill=BOULDER 100 DIAMOND 50 STEELWALL 9 SPACE 0
ActiveGuyIsFirst=false
MagicWallTime=0 0 0 0 0
MagicWallProperties.convertamoeba=false
MagicWallProperties.breakscan=true
SlimePermeabilityC64=0 0 0 0 0
Effect=ACIDEffect ACID
AcidProperties=DIRT 0.0157
BorderProperties.lineshift=true
BorderProperties.objectwraparound=true

[objects]
Point=10 8 INBOX
Point=15 8 OUTBOX
[/objects]
[/cave]

[cave]
Name=Cave D
Selectable=false
IntermissionProperties.instantlife=true
Intermission=false
IntermissionProperties.rewardlife=false
Size=40 22 0 0 39 21
Colors=Black Black Cyan Blue White White White
DiamondsRequired=74 74 74 74 74
CaveTime=250 250 250 250 250
CaveScheduling=bd1
PALTiming=true
FrameTime=180 160 140 120 120
CaveDelay=12 6 3 1 0
DiamondValue=5 10
RandSeed=0 110 112 115 119
RandomFill=DIAMOND 20 SPACE 0 SPACE 0 SPACE 0
ActiveGuyIsFirst=false
AmoebaTime=20 20 20 20 20
MagicWallTime=20 20 20 20 20
MagicWallProperties.convertamoeba=false
MagicWallProperties.breakscan=true
SlimePermeabilityC64=0 0 0 0 0
Effect=ACIDEffect ACID
AcidProperties=DIAMOND 0.0000
BorderProperties.lineshift=true
BorderProperties.objectwraparound=true

[objects]
Line=1 1 20 20 BUTTERFLYd
Line=19 1 1 19 BUTTERFLYd
Point=1 9 INBOX
Line=20 1 38 19 BUTTERFLYd
Line=38 1 19 20 BUTTERFLYd
FillRect=18 1 21 20 SPACE
Point=38 9 OUTBOX
[/objects]
[/cave]

[cave]
Name=Intermission 1
Selectable=false
IntermissionProperties.instantlife=true
Intermission=true
IntermissionProperties.rewardlife=false
Size=40 22 0 0 19 11
Colors=Black Black LightBlue LightGreen White White White
DiamondsRequired=1 1 1 1 1
CaveTime=15 15 15 15 15
CaveScheduling=bd1
PALTiming=true
FrameTime=180 160 140 120 120
CaveDelay=12 6 3 1 0
DiamondValue=50 0
RandSeed=10 11 12 13 14
RandomFill=SPACE 0 SPACE 0 SPACE 0 SPACE 0
ActiveGuyIsFirst=false
AmoebaTime=20 20 20 20 20
MagicWallTime=20 20 20 20 20
MagicWallProperties.convertamoeba=false
MagicWallProperties.breakscan=true
SlimePermeabilityC64=0 0 0 0 0
Effect=ACIDEffect ACID
AcidProperties=SPACE 0.0000
BorderProperties.lineshift=true
BorderProperties.objectwraparound=true

[objects]
FillRect=0 0 19 11 STEELWALL DIRT
Point=1 1 INBOX
Point=17 8 OUTBOX
Point=1 8 DIAMOND
Line=12 1 5 8 FIREFLYl
Line=15 3 8 10 FIREFLYl
[/objects]
[/cave]

[cave]
Name=Cave E
IntermissionProperties.instantlife=true
Intermission=false
IntermissionProperties.rewardlife=false
Size=40 22 0 0 39 21
Colors=Black Black Yellow Cyan Red Red Red
DiamondsRequired=62 62 62 62 62
CaveTime=255 255 255 255 255
CaveScheduling=bd1
PALTiming=true
FrameTime=180 160 140 120 120
CaveDelay=12 6 3 1 0
DiamondValue=11 1
RandSeed=0 0 0 0 0
RandomFill=SPACE 0 SPACE 0 SPACE 0 SPACE 0
ActiveGuyIsFirst=false
AmoebaTime=20 20 20 20 20
MagicWallTime=20 20 20 20 20
MagicWallProperties.convertamoeba=false
MagicWallProperties.breakscan=true
SlimePermeabilityC64=0 0 0 0 0
Effect=ACIDEffect ACID
AcidProperties=SPACE 0.0000
BorderProperties.lineshift=true
BorderProperties.objectwraparound=true

[objects]
FillRect=0 0 39 21 WALL
Line=1 6 1 18 DIAMOND
Line=38 6 38 18 DIAMOND
Line=1 1 1 5 FIREFLYl
Line=38 1 38 5 FIREFLYl
Line=2 18 37 18 DIRT
Line=4 2 4 14 DIRT
Line=35 2 35 14 DIRT
Line=4 15 35 15 DIRT
Line=7 3 7 12 DIRT
Line=32 3 32 12 DIRT
Line=8 12 31 12 DIRT
Line=20 10 20 20 DIRT
FillRect=10 3 29 9 SPACE DIRT
Line=10 3 10 9 FIREFLYl
Line=29 3 29 9 FIREFLYl
FillRect=14 5 25 7 DIAMOND
Point=20 19 INBOX
Point=20 20 OUTBOX
[/objects]
[/cave]

[cave]
Name=Cave F
Selectable=false
IntermissionProperties.instantlife=true
Intermission=false
IntermissionProperties.rewardlife=false
Size=40 22 0 0 39 21
Colors=Black Black Brown Cyan White White White
DiamondsRequired=99 99 99 99 99
CaveTime=250 220 250 250 250
CaveScheduling=bd1
PALTiming=true
FrameTime=180 160 140 120 120
CaveDelay=12 6 3 1 0
DiamondValue=5 13
RandSeed=0 20 21 22 23
RandomFill=SPACE 0 SPACE 0 SPACE 0 SPACE 0
ActiveGuyIsFirst=false
AmoebaTime=20 20 20 20 20
MagicWallTime=20 20 20 20 20
MagicWallProperties.convertamoeba=false
MagicWallProperties.breakscan=true
SlimePermeabilityC64=0 0 0 0 0
Effect=ACIDEffect ACID
AcidProperties=SPACE 0.0000
BorderProperties.lineshift=true
BorderProperties.objectwraparound=true

[objects]
Line=1 2 38 2 STEELWALL
Line=1 3 38 3 DIAMOND
Line=1 4 38 4 STEELWALL
Line=1 5 38 5 DIAMOND
Line=1 6 38 6 STEELWALL
Line=1 7 38 7 DIAMOND
Line=1 8 38 8 STEELWALL
Line=1 9 38 9 SPACE
Line=1 10 38 10 STEELWALL
Line=1 11 38 11 DIAMOND
Line=1 12 38 12 STEELWALL
Line=1 13 38 13 SPACE
Rectangle=6 1 7 8 SPACE
Rectangle=6 1 7 8 SPACE
Rectangle=25 2 26 8 FIREFLYl
Rectangle=6 1 7 8 SPACE
Rectangle=10 9 11 13 SPACE
Rectangle=19 9 20 13 SPACE
Rectangle=28 9 29 13 SPACE
FillRect=1 14 38 20 STEELWALL
Point=1 13 INBOX
Point=38 1 OUTBOX
Line=3 9 9 9 FIREFLYl
[/objects]
[/cave]

[cave]
Name=Cave G
Selectable=false
IntermissionProperties.instantlife=true
Intermission=false
IntermissionProperties.rewardlife=false
Size=40 22 0 0 39 21
Colors=Black Black Blue LightBlue Cyan Cyan Cyan
DiamondsRequired=20 20 20 20 20
CaveTime=210 210 210 210 210
CaveScheduling=bd1
PALTiming=true
FrameTime=180 160 140 120 120
CaveDelay=12 6 3 1 0
DiamondValue=10 0
RandSeed=2 7 8 10 9
RandomFill=BOULDER 25 SPACE 0 SPACE 0 SPACE 0
ActiveGuyIsFirst=false
AmoebaTime=75 75 75 75 75
MagicWallTime=75 75 75 75 75
MagicWallProperties.convertamoeba=false
MagicWallProperties.breakscan=true
SlimePermeabilityC64=0 0 0 0 0
Effect=ACIDEffect ACID
AcidProperties=ACID 0.0000
BorderProperties.lineshift=true
BorderProperties.objectwraparound=true

[objects]
Line=1 1 14 1 FIREFLYl
Line=1 20 14 20 FIREFLYl
Line=6 1 25 20 WALL
Line=13 1 32 20 WALL
Line=25 1 6 20 WALL
Line=32 1 13 20 WALL
Point=19 13 AMOEBA
Point=19 1 INBOX
Point=19 20 OUTBOX
[/objects]
[/cave]

[cave]
Name=Cave H
Selectable=false
IntermissionProperties.instantlife=true
Intermission=false
IntermissionProperties.rewardlife=false
Size=40 22 0 0 39 21
Colors=Black Black Purple Red Yellow Yellow Yellow
DiamondsRequired=30 30 30 30 30
CaveTime=250 250 250 250 250
CaveScheduling=bd1
PALTiming=true
FrameTime=180 160 140 120 120
CaveDelay=12 6 3 1 0
DiamondValue=10 20
RandSeed=1 3 4 5 6
RandomFill=SPACE 0 SPACE 0 SPACE 0 SPACE 0
ActiveGuyIsFirst=false
AmoebaTime=20 20 20 20 20
MagicWallTime=20 20 20 20 20
MagicWallProperties.convertamoeba=false
MagicWallProperties.breakscan=true
SlimePermeabilityC64=0 0 0 0 0
Effect=ACIDEffect ACID
AcidProperties=SPACE 0.0000
BorderProperties.lineshift=true
BorderProperties.objectwraparound=true

[objects]
Line=6 2 11 7 WALL
FillRect=13 1 30 4 BOULDER
Line=38 1 31 8 WALL
Rectangle=12 8 31 8 WALL
Line=15 12 28 12 MAGICWALL
Point=5 13 BOULDER
Point=8 16 BOULDER
Line=38 10 28 20 FIREFLYl
Line=1 12 9 20 WALL
Line=1 15 6 20 WALL
Point=6 1 INBOX
Point=3 20 OUTBOX
[/objects]
[/cave]

[cave]
Name=Intermission 2
Selectable=false
IntermissionProperties.instantlife=true
Intermission=true
IntermissionProperties.rewardlife=false
Size=40 22 0 0 19 11
Colors=Black Black LightGreen Blue White White White
DiamondsRequired=35 35 40 40 45
CaveTime=45 45 40 40 40
CaveScheduling=bd1
PALTiming=true
FrameTime=180 160 140 120 120
CaveDelay=12 6 3 1 0
DiamondValue=10 20
RandSeed=10 11 12 13 14
RandomFill=SPACE 0 SPACE 0 SPACE 0 SPACE 0
ActiveGuyIsFirst=false
AmoebaTime=20 20 20 20 20
MagicWallTime=20 20 20 20 20
MagicWallProperties.convertamoeba=false
MagicWallProperties.breakscan=true
SlimePermeabilityC64=0 0 0 0 0
Effect=ACIDEffect ACID
AcidProperties=SPACE 0.0000
BorderProperties.lineshift=true
BorderProperties.objectwraparound=true

[objects]
Rectangle=0 0 19 11 STEELWALL
Line=9 1 9 10 STEELWALL
Line=1 6 18 6 STEELWALL
Rectangle=8 5 10 7 SPACE
Line=15 1 18 4 BUTTERFLYd
Point=1 10 AMOEBA
Point=1 1 INBOX
Point=3 1 OUTBOX
Point=1 3 STEELWALL
Point=18 10 FIREFLYl
[/objects]
[/cave]

[cave]
Name=Cave I
IntermissionProperties.instantlife=true
Intermission=false
IntermissionProperties.rewardlife=false
Size=40 22 0 0 39 21
Colors=Black Black Red Blue White White White
DiamondsRequired=66 66 66 66 66
CaveTime=55 50 45 42 40
CaveScheduling=bd1
PALTiming=true
FrameTime=180 160 140 120 120
CaveDelay=12 6 3 1 0
DiamondValue=5 10
RandSeed=100 137 140 251 51
RandomFill=SPACE 0 SPACE 0 SPACE 0 SPACE 0
ActiveGuyIsFirst=false
AmoebaTime=20 20 20 20 20
MagicWallTime=20 20 20 20 20
MagicWallProperties.convertamoeba=false
MagicWallProperties.breakscan=true
SlimePermeabilityC64=0 0 0 0 0
Effect=ACIDEffect ACID
AcidProperties=SPACE 0.0000
BorderProperties.lineshift=true
BorderProperties.objectwraparound=true

[objects]
FillRect=1 1 11 6 DIAMOND
Line=1 7 37 7 WALL
Rectangle=2 9 38 11 WALL
Rectangle=1 13 37 15 WALL
Rectangle=2 17 38 19 WALL
Point=38 20 INBOX
Point=39 20 OUTBOX
[/objects]
[/cave]

[cave]
Name=Cave J
Selectable=false
IntermissionProperties.instantlife=true
Intermission=false
IntermissionProperties.rewardlife=false
Size=40 22 0 0 39 21
Colors=Black Black Green LightGreen White White White
DiamondsRequired=40 40 40 40 40
CaveTime=250 250 250 250 250
CaveScheduling=bd1
PALTiming=true
FrameTime=180 160 140 120 120
CaveDelay=12 6 3 1 0
DiamondValue=5 10
RandSeed=0 0 0 0 0
RandomFill=SPACE 0 SPACE 0 SPACE 0 SPACE 0
ActiveGuyIsFirst=false
AmoebaTime=20 20 20 20 20
MagicWallTime=20 20 20 20 20
MagicWallProperties.convertamoeba=false
MagicWallProperties.breakscan=true
SlimePermeabilityC64=0 0 0 0 0
Effect=ACIDEffect ACID
AcidProperties=SPACE 0.0000
BorderProperties.lineshift=true
BorderProperties.objectwraparound=true

[objects]
Rectangle=4 19 6 21 STEELWALL
Rectangle=6 4 21 20 WALL
Line=7 13 20 13 MAGICWALL
Rectangle=21 1 24 7 WALL
Point=1 20 AMOEBA
Point=5 20 OUTBOX
FillRect=7 14 20 20 SPACE
Point=7 15 DIRT
Point=22 1 BOULDER
Point=22 8 BOULDER
Point=25 1 BOULDER
Point=21 12 SPACE
Point=23 6 FIREFLYl
Line=30 8 32 10 FIREFLYl
Point=38 20 INBOX
Point=24 3 STEELWALL
Point=24 5 STEELWALL
[/objects]
[/cave]

[cave]
Name=Cave K
Selectable=false
IntermissionProperties.instantlife=true
Intermission=false
IntermissionProperties.rewardlife=false
Size=40 22 0 0 39 21
Colors=Black Black Brown Cyan White White White
DiamondsRequired=84 84 84 84 84
CaveTime=220 220 250 200 200
CaveScheduling=bd1
PALTiming=true
FrameTime=180 160 140 120 120
CaveDelay=12 6 3 1 0
DiamondValue=3 0
RandSeed=0 4 102 151 100
RandomFill=SPACE 0 SPACE 0 SPACE 0 SPACE 0
ActiveGuyIsFirst=false
AmoebaTime=20 20 20 20 20
MagicWallTime=20 20 20 20 20
MagicWallProperties.convertamoeba=false
MagicWallProperties.breakscan=true
SlimePermeabilityC64=0 0 0 0 0
Effect=ACIDEffect ACID
AcidProperties=SPACE 0.0000
BorderProperties.lineshift=true
BorderProperties.objectwraparound=true

[objects]
FillRect=1 1 38 20 WALL
Line=35 2 35 19 SPACE
FillRect=20 14 33 19 DIAMOND
Line=31 11 33 11 FIREFLYl
Point=7 12 INBOX
Point=6 12 OUTBOX
Line=8 3 8 12 DIRT
Point=8 2 BOULDER
Line=9 2 15 8 DIRT
Line=9 3 16 10 DIRT
FillRect=17 2 33 10 DIRT
Point=16 9 FIREFLYl
Point=22 2 BOULDER
Point=27 3 BOULDER
Line=2 6 7 6 DIRT
Point=2 6 FIREFLYl
[/objects]
[/cave]

[cave]
Name=Cave L
Description=Fixed for GDash: "Scan first and last line" disabled, inbox moved one tile up
Selectable=false
IntermissionProperties.instantlife=true
Intermission=false
IntermissionProperties.rewardlife=false
Size=40 22 0 0 39 21
Colors=Black Black Green Cyan White White White
DiamondsRequired=99 99 99 99 99
CaveTime=200 200 200 200 200
CaveScheduling=bd1
PALTiming=true
FrameTime=180 160 140 120 120
CaveDelay=12 6 3 1 0
DiamondValue=5 0
RandSeed=0 60 2 59 102
RandomFill=SPACE 0 SPACE 0 SPACE 0 SPACE 0
ActiveGuyIsFirst=false
AmoebaTime=20 20 20 20 20
MagicWallTime=20 20 20 20 20
MagicWallProperties.convertamoeba=false
MagicWallProperties.breakscan=true
SlimePermeabilityC64=0 0 0 0 0
Effect=ACIDEffect ACID
AcidProperties=SPACE 0.0000
BorderProperties.lineshift=true
BorderProperties.objectwraparound=true
BorderProperties.scan=false

[objects]
Point=1 20 OUTBOX
Point=1 19 FIREFLYl
Line=2 2 2 20 WALL
Line=2 2 14 2 WALL
Line=14 2 14 19 WALL
Line=18 1 18 20 WALL
Point=19 3 BOULDER
Line=22 1 22 20 WALL
Point=23 3 BOULDER
Line=25 1 25 19 WALL
Point=26 3 BOULDER
Line=37 1 26 12 WALL
Line=31 7 30 8 FIREFLYl
Point=29 13 BOULDER
Line=25 19 36 19 WALL
Point=29 20 INBOX
FillRect=3 3 13 20 DIAMOND
Point=29 21 SPACE
[/objects]
[/cave]

[cave]
Name=Intermission 3
Selectable=false
IntermissionProperties.instantlife=true
Intermission=true
IntermissionProperties.rewardlife=false
Size=40 22 0 0 19 11
Colors=Black Black Red Cyan Blue Blue Blue
DiamondsRequired=10 10 10 10 10
CaveTime=50 50 50 50 50
CaveScheduling=bd1
PALTiming=true
FrameTime=180 160 140 120 120
CaveDelay=12 6 3 1 0
DiamondValue=50 0
RandSeed=10 11 12 13 14
RandomFill=BUTTERFLYd 50 FIREFLYl 42 BOULDER 34 DIAMOND 17
ActiveGuyIsFirst=false
AmoebaTime=4 4 4 4 4
MagicWallTime=4 4 4 4 4
MagicWallProperties.convertamoeba=false
MagicWallProperties.breakscan=true
SlimePermeabilityC64=0 0 0 0 0
Effect=ACIDEffect ACID
AcidProperties=BUTTERFLYu 0.0000
BorderProperties.lineshift=true
BorderProperties.objectwraparound=true

[objects]
Rectangle=0 0 19 11 STEELWALL
Line=30 1 30 10 WALL
Rectangle=1 1 3 3 DIRT
Rectangle=16 8 18 10 DIRT
Point=17 9 OUTBOX
Point=2 2 INBOX
[/objects]
[/cave]

[cave]
Name=Cave M
IntermissionProperties.instantlife=true
Intermission=false
IntermissionProperties.rewardlife=false
Size=40 22 0 0 39 21
Colors=Black Black Brown Orange Red Red Red
DiamondsRequired=50 55 60 70 70
CaveTime=160 155 150 145 150
CaveScheduling=bd1
PALTiming=true
FrameTime=180 160 140 120 120
CaveDelay=12 6 3 1 0
DiamondValue=5 30
RandomFill=BOULDER 40 SPACE 0 SPACE 0 SPACE 0
ActiveGuyIsFirst=false
AmoebaTime=140 140 140 140 140
MagicWallTime=140 140 140 140 140
MagicWallProperties.convertamoeba=false
MagicWallProperties.breakscan=true
SlimePermeabilityC64=0 0 0 0 0
Effect=ACIDEffect ACID
AcidProperties=GUYBIRTH3 0.0000
BorderProperties.lineshift=true
BorderProperties.objectwraparound=true

[objects]
Line=1 1 20 20 BUTTERFLYd
Point=38 1 AMOEBA
Point=28 1 INBOX
Point=38 6 OUTBOX
[/objects]
[/cave]

[cave]
Name=Cave N
Selectable=false
IntermissionProperties.instantlife=true
Intermission=false
IntermissionProperties.rewardlife=false
Size=40 22 0 0 39 21
Colors=Black Black Red Blue White White White
DiamondsRequired=60 60 60 60 60
CaveTime=200 200 200 200 200
CaveScheduling=bd1
PALTiming=true
FrameTime=180 160 140 120 120
CaveDelay=12 6 3 1 0
DiamondValue=10 20
RandSeed=0 0 0 0 0
RandomFill=SPACE 0 SPACE 0 SPACE 0 SPACE 0
ActiveGuyIsFirst=false
AmoebaTime=20 20 20 20 20
MagicWallTime=20 20 20 20 20
MagicWallProperties.convertamoeba=false
MagicWallProperties.breakscan=true
SlimePermeabilityC64=0 0 0 0 0
Effect=ACIDEffect ACID
AcidProperties=SPACE 0.0000
BorderProperties.lineshift=true
BorderProperties.objectwraparound=true

[objects]
FillRect=1 1 17 7 STEELWALL
FillRect=1 13 17 20 STEELWALL
FillRect=23 1 38 7 STEELWALL
FillRect=23 13 38 20 STEELWALL
Line=21 1 21 19 BUTTERFLYd
Line=1 9 38 9 BOULDER
Point=21 5 DIRT
Point=21 13 DIRT
Point=21 14 DIRT
Point=21 18 DIRT
Point=1 13 INBOX
Point=38 13 OUTBOX
[/objects]
[/cave]

[cave]
Name=Cave O
Selectable=false
IntermissionProperties.instantlife=true
Intermission=false
IntermissionProperties.rewardlife=false
Size=40 22 0 0 39 21
Colors=Black Black Purple Blue White White White
DiamondsRequired=99 99 99 99 99
CaveTime=200 200 200 200 200
CaveScheduling=bd1
PALTiming=true
FrameTime=180 160 140 120 120
CaveDelay=12 6 3 1 0
DiamondValue=5 90
RandSeed=1 29 30 31 32
RandomFill=SPACE 0 BOULDER 40 SPACE 0 SPACE 0
ActiveGuyIsFirst=false
AmoebaTime=8 8 8 8 8
MagicWallTime=8 8 8 8 8
MagicWallProperties.convertamoeba=false
MagicWallProperties.breakscan=true
SlimePermeabilityC64=0 0 0 0 0
Effect=ACIDEffect ACID
AcidProperties=SPACE 0.0000
BorderProperties.lineshift=true
BorderProperties.objectwraparound=true

[objects]
Line=13 1 13 19 WALL
FillRect=1 1 12 11 FIREFLYl
FillRect=1 12 12 20 DIAMOND
Point=38 1 INBOX
Point=35 9 OUTBOX
Point=30 9 AMOEBA
[/objects]
[/cave]

[cave]
Name=Cave P
Selectable=false
IntermissionProperties.instantlife=true
Intermission=false
IntermissionProperties.rewardlife=false
Size=40 22 0 0 39 21
Colors=Black Black Brown Gray3 Yellow Yellow Yellow
DiamondsRequired=95 95 95 95 95
CaveTime=200 200 200 200 200
CaveScheduling=bd1
PALTiming=true
FrameTime=180 160 140 120 120
CaveDelay=12 6 3 1 0
DiamondValue=10 0
RandSeed=1 120 129 126 123
RandomFill=FIREFLYl 50 SPACE 25 SPACE 0 SPACE 0
ActiveGuyIsFirst=false
AmoebaTime=20 20 20 20 20
MagicWallTime=20 20 20 20 20
MagicWallProperties.convertamoeba=false
MagicWallProperties.breakscan=true
SlimePermeabilityC64=0 0 0 0 0
Effect=ACIDEffect ACID
AcidProperties=BUTTERFLYu 0.0000
BorderProperties.lineshift=true
BorderProperties.objectwraparound=true

[objects]
FillRect=35 0 38 21 STEELWALL DIRT
FillRect=1 17 34 20 STEELWALL
Line=34 1 34 20 DIRT
Line=15 18 33 18 DIRT
Line=15 18 19 18 FIREFLYl
Line=20 20 33 20 DIRT
Point=35 1 AMOEBA
Line=33 1 33 17 STEELWALL
Point=32 1 BOULDER
Point=33 4 WALL
Point=33 12 WALL
Point=32 11 BOULDER
Point=32 13 STEELWALL
Point=34 18 INBOX
Point=2 2 OUTBOX
[/objects]
[/cave]

[cave]
Name=Intermission 4
Selectable=false
IntermissionProperties.instantlife=true
Intermission=true
IntermissionProperties.rewardlife=false
Size=40 22 0 0 19 11
Colors=Black Black Brown Cyan White White White
DiamondsRequired=24 24 24 24 24
CaveTime=20 20 20 20 20
CaveScheduling=bd1
PALTiming=true
FrameTime=180 160 140 120 120
CaveDelay=12 6 3 1 0
DiamondValue=20 0
RandSeed=0 0 0 0 0
RandomFill=SPACE 0 SPACE 0 SPACE 0 SPACE 0
ActiveGuyIsFirst=false
AmoebaTime=3 3 3 3 3
MagicWallTime=3 3 3 3 3
MagicWallProperties.convertamoeba=false
MagicWallProperties.breakscan=true
SlimePermeabilityC64=0 0 0 0 0
Effect=ACIDEffect ACID
AcidProperties=SPACE 0.0000
BorderProperties.lineshift=true
BorderProperties.objectwraparound=true

[objects]
FillRect=0 0 19 11 STEELWALL WALL
Line=18 1 18 10 SPACE
FillRect=9 1 16 5 DIRT
Line=16 10 1 10 DIAMOND
Line=9 1 10 1 FIREFLYl
Point=10 5 INBOX
Point=1 10 OUTBOX
Line=13 1 16 1 BOULDER
Line=5 1 5 9 DIAMOND
[/objects]
[/cave]
[/game]
[/BDCFF]
