[BDCFF]
Version=0.5

[game]
Name=Dotter Dash 07
Levels=5

[cave]
Name=Cave 01
IntermissionProperties.instantlife=true
Intermission=false
IntermissionProperties.rewardlife=false
Size=40 22 0 0 39 21
Colors=Atari00 Atari00 Ataric6 Atari42 Atariea Atariea Atariea
DiamondsRequired=45 45 45 45 45
CaveTime=167 167 167 167 167
CaveScheduling=bd2ckatari
PALTiming=true
FrameTime=100 100 100 100 100
CaveDelay=5 5 5 5 5
TimeValue=1 1 1 1 1
DiamondValue=3 4
RandSeed=0 0 0 0 0
ActiveGuyIsFirst=false
AmoebaProperties.immediately=false
AmoebaTime=255 255 255 255 255
MagicWallTime=255 255 255 255 255
MagicWallProperties.convertamoeba=false
SlimePermeabilityC64=0 0 0 0 0
BorderProperties.lineshift=true
BorderProperties.objectwraparound=true
BorderProperties.scan=false

[map]
WWWWWWWWWWWWWWWWWWWWWWWWWWWWWWWWWWWWWWWW
WPr WddddWX............................W
WWW W...dd..W..........................W
WW  W craWWWWWWWWWWWWWWWWWWWWWWWWWWWWW.W
W  dW .raW        W..r.rw w.rQwrw.W.rw.W
W WWW craWrxW WWW W..c.cw w.W wQw.W.rw.W
W  WW .raW.dWQWWW W..r.rw w.W wrw.W.Qw.W
Wd  W craWQWx.W   W..c.cw w.W wQw.W.rw.W
WWW W .raW W..W.xWW..rrrw w.W wrw.W.rw.W
WW  W craW w.WW.Wdd...Q.w w.W wQw.W.rw.W
W  dW .raW WWW..WWW.MMrWw w.W wrw.W.rw.W
W WWW craW Wdd..r wwxxrWMMM.W wQw.W.rw.W
W  WW .raW WWWWWWcwrWwrWw w.W wrw.W.rw.W
Wd  W craW      W wrWw..wQw.W wQw.W.rw.W
WWW W .raWWWWWW W.wrWWw.w w.W wrw.W.rw.W
WW  W craW    W WQwr..W.w w.W wQw.W..w.W
W  dW .raW WW W W wrW.W.w w.W wrw.W.Mw.W
W WWWxxraW  W W W.wrW.W.w w.W wQw.W.Ww.W
W  WWxxrWWWWW W WQwrW.W.w w.W wrw.W..w.W
Wd    ....... W W wrW...wMwWW wQw..W.w.W
WWWWW WMWWWWW   W wrWMMMwMwdd wrwx...w.W
WWWWWWWWWWWWWWWWWWWWWWWWWWWWWWWWWWWWWWWW
[/map]
[/cave]

[cave]
Name=Cave 02
IntermissionProperties.instantlife=true
Intermission=false
IntermissionProperties.rewardlife=false
Size=40 22 0 0 39 21
Colors=Atari00 Atari00 Atari72 Atari72 Atari9a Atari9a Atari9a
DiamondsRequired=97 97 97 97 97
CaveTime=180 180 180 180 180
CaveScheduling=bd2ckatari
PALTiming=true
FrameTime=120 120 120 120 120
CaveDelay=6 6 6 6 6
TimeValue=1 1 1 1 1
DiamondValue=2 3
RandSeed=0 0 0 0 0
ActiveGuyIsFirst=false
AmoebaProperties.immediately=false
AmoebaTime=40 40 40 40 40
MagicWallTime=255 255 255 255 255
MagicWallProperties.convertamoeba=false
SlimePermeabilityC64=0 0 0 0 0
BorderProperties.lineshift=true
BorderProperties.objectwraparound=true
BorderProperties.scan=false

[map]
WWWWWWWWWWWWWWWWWWWWWWWWWWWWWWWWWWWWWWWW
W   ............r.............d.d.r.d.WW
Wc  WWWWWW................WWWWWWWWrWWdWW
WWWWW...................WWW.. r....WW.dW
W.....WWWWWWWWWWWWWWWWWWW..rW WWWWccWW.W
W.WWWWW r.................WrWMWWrWWQcWXW
W.. r r WWWWWWWWWWWWWWWWWWW......WWWrWWW
WWW W W ....................WWWW......WW
WWWMWMWMW.WWWWWWWWWWWWWWWrWWWWWWrWWWM.WW
W.........WWWWWWWWrWrWrWr.WWWrW .  W..WW
W.........WW.r WWW........Wr.cW   WW.wwW
W.r r rQr WWrW w.Wr.r.r.r.Wc.rW   w..waW
W.W WQW WQWrQwQw.W........Wr.cW   wddwaW
W.WQW W W WQrw w.WM.M.M.M.Wc.rW   wadwaW
W.WwWwWwWwWr.w w.W........Wr.cW   wadwaW
W.WaWaWaWaWr.w w.WM.M.M.M.W..rWWW wadaaW
W.WaWaWaWaWr.w w.W........WW..FFWWWadaaW
W.WaWaWaWaWr.w w.Ww.w.w.w..W.WWWWcWadaaW
W.WaWaWaWaW..w w..WM.M.M.M.W....WcWadaaW
W.WWWWWWWWWdWWWWW..........WWWW.WcWadaaW
W........PdaWWWWWWWWWWWWWW......WcWadaaW
WWWWWWWWWWWWWWWWWWWWWWWWWWWWWWWWWWWWWWWW
[/map]
[/cave]

[cave]
Name=Cave 03
IntermissionProperties.instantlife=true
Intermission=false
IntermissionProperties.rewardlife=false
Size=40 22 0 0 39 21
Colors=Atari00 Atari00 Ataric6 Atarif4 Atariea Atariea Atariea
DiamondsRequired=98 98 98 98 98
CaveTime=209 209 209 209 209
CaveScheduling=bd2ckatari
PALTiming=true
FrameTime=120 120 120 120 120
CaveDelay=6 6 6 6 6
TimeValue=1 1 1 1 1
DiamondValue=1 2
RandSeed=0 0 0 0 0
ActiveGuyIsFirst=false
AmoebaProperties.immediately=false
MagicWallTime=0 0 0 0 0
MagicWallProperties.convertamoeba=false
SlimePermeabilityC64=0 0 0 0 0
BorderProperties.lineshift=true
BorderProperties.objectwraparound=true
BorderProperties.scan=false

[map]
WWWWWWWWWWWWWWWWWWWWWWWWWWWWWWWWWWWWWWWW
W   W..................W...............W
WcWcW....W.........d..dW.WWWWWWWWWWWWW.W
W WWW...WW........daddaW.W...........W.W
WrW....dWWwwwwwwwwwwwwwW.W.WWWWWWWWW.W.W
WQWW....WW            wW.W.....W...W.W.W
WrWWW..dWWw          d.W.WWWWW.W.W.W.W.W
WrWWWW..WWww        w.WW.......W.W.W.W.W
WrWWWWWdWW.ww      ww.WWWWWWWWWW.W.W.W.W
WQWWWWW.WW..ww    ww..WW.......W.W.W.W.W
WrWWWWWdWW...ww  ww..WWW.WWWWW.W.W.W.W.W
WrWWWWW.WW....wMMw..WWWW.W..aW.W.W.W.W.W
WrWWWWWdaW.....  ..WWWWW...WXW...W...W.W
WQWWWWW.WW....  w.WWWWWWWWWWWWWWWWWWWW.W
WrWWWWWdaW...  wx.WW                   W
WrWWWWW.WW..  ww                       W
WrWWWWWdaW.. ww                        W
WQWWWWW.WW..Mw                         W
WrWWWWWdaW.. W                         W
WP......WW.. WdcdcdcdcdcdcdcdcdcdcdcdcdW
WMWWWWWWWW..cWaWaWaWaWaWaWaWaWaWaWaWaWaW
WWWWWWWWWWWWWWWWWWWWWWWWWWWWWWWWWWWWWWWW
[/map]
[/cave]

[cave]
Name=Cave 04
IntermissionProperties.instantlife=true
Intermission=false
IntermissionProperties.rewardlife=false
Size=40 22 0 0 39 21
Colors=Atari00 Atari00 Atari42 Ataric6 Atari00 Atari00 Atari00
DiamondsRequired=97 97 97 97 97
CaveTime=250 250 250 250 250
CaveScheduling=bd2ckatari
PALTiming=true
FrameTime=120 120 120 120 120
CaveDelay=6 6 6 6 6
TimeValue=1 1 1 1 1
DiamondValue=2 1
RandSeed=0 0 0 0 0
ActiveGuyIsFirst=false
AmoebaProperties.immediately=false
AmoebaTime=255 255 255 255 255
MagicWallTime=0 0 0 0 0
MagicWallProperties.convertamoeba=false
SlimePermeabilityC64=0 0 0 0 0
BorderProperties.lineshift=true
BorderProperties.objectwraparound=true
BorderProperties.scan=false

[map]
WWWWWWWWWWWWWWWWWWWWWWWWWWWWWWWWWWWWWWWW
WWXWWWWW. r W               W          W
WW.W.W.W. W WW           WW W          W
WW.W.W.W.QW  WW         WW  W          W
WW.W.W.WW.cW  WW       WW  WW          W
WW.W.W.WWWcWW  WW     WW  WW           W
WW.W.W.WWWc WW  WW   WW  WW            W
WW.W.W.WW..c WW  WWaWW  WW             W
WW.W.W.W ...c WW  WWW  WW              W
WW.W.W.Wcr...c WW  W  WW       W       W
WW.W.W.Wc..r..c WW   WW       dad      W
WW.W.W.Wcr...r.c W P Wa       .W.      W
WW.W.W.W ..r.. cWW   WW        W       W
WW.....Wcr... cWW  W  WW       W       W
WWWWWW.Wc... cWW  WWW  WW      W       W
WWWrWW.Wcr. cWW  WWaWW  WW    WW       W
WWWcWW.Wc. cWW  WW   WW  WW  WW        W
WWWrWW.WcrcWW  WW     WW  WWWW         W
W...F..Wc.cW  WW       WW              W
W.WWWWWWc.cW WW         WW             W
W.......cccW             W             W
WWWWWWWWWWWWWWWWWWWWWWWWWWWWWWWWWWWWWWWW
[/map]
[/cave]

[cave]
Name=Cave 05
IntermissionProperties.instantlife=true
Intermission=false
IntermissionProperties.rewardlife=false
Size=40 22 0 0 39 21
Colors=Atari00 Atari04 Atari34 Atari00 Atari0f Atari0f Atari0f
DiamondsRequired=30 30 30 30 30
CaveTime=255 255 255 255 255
CaveScheduling=bd2ckatari
PALTiming=true
FrameTime=140 140 140 140 140
CaveDelay=7 7 7 7 7
TimeValue=1 1 1 1 1
DiamondValue=0 2
RandSeed=0 0 0 0 0
ActiveGuyIsFirst=false
AmoebaProperties.immediately=false
MagicWallTime=0 0 0 0 0
MagicWallProperties.convertamoeba=false
SlimePermeabilityC64=0 0 0 0 0
BorderProperties.lineshift=true
BorderProperties.objectwraparound=true
BorderProperties.scan=false

[map]
WWWWWWWWWWWWWWWWWWWWWWWWWWWWWWWWWWWWWWWW
W WQWWdW.wwwwwwWrrrr....rWW           QW
WQWQW....dadQQQW....WWW.rrW WWWWWW.xWW W
W WrWWWW.wawwwwW   wx.r.r.  Wd.x...d.WQW
WQW.     wawQQQW    W.W.wW WWx.xdxxx.W W
WrW      wawwwwW  c W.W.WW Wd.....dx.WQW
W.       wawQQQW    W.W.WW W.xdxdx..dW W
W    P   wawwwwW  c W.W.WW WWWWWWW.xWWQW
W        wawQQQW    W.W.WW Q Q Q Q Q Q W
Wd       wawwwwW  c W.W.WWWWW.xWWWWWWWWW
WQd      wawQQQW    W.W.W.........X....W
WWWWWWW  wawwwwW  c W.W.W..............W
W.....W  wawQQQW    W.W.W..............W
WWWWW.W  wawwwwW  c W.W.W..............W
W...W.W  wawQQQW    W.W.W..............W
W.W...W  wawwwwW  c W.W.W..............W
W.WWWWW  wawQQQW    W.W.W..............W
W.....W  wawwwwr  c W.W.W..............W
W.W.W.W  wawQQQ.    W.W.W..............W
W.W.W.W  wawwwwr  c W.W.W..............W
WaW.W.W  wawQQQ.    W...W..............W
WWWWWWWWWWWWWWWWWWWWWWWWWWWWWWWWWWWWWWWW
[/map]
[/cave]

[cave]
Name=Cave 06
IntermissionProperties.instantlife=true
Intermission=false
IntermissionProperties.rewardlife=false
Size=40 22 0 0 39 21
Colors=Atari00 Atari06 Atarica Atari34 Atari00 Atari00 Atari00
DiamondsRequired=15 15 15 15 15
CaveTime=50 50 50 50 50
CaveScheduling=bd2ckatari
PALTiming=true
FrameTime=100 100 100 100 100
CaveDelay=5 5 5 5 5
TimeValue=1 1 1 1 1
DiamondValue=5 7
RandSeed=0 0 0 0 0
ActiveGuyIsFirst=false
AmoebaProperties.immediately=false
AmoebaTime=255 255 255 255 255
MagicWallTime=0 0 0 0 0
MagicWallProperties.convertamoeba=false
SlimePermeabilityC64=0 0 0 0 0
BorderProperties.lineshift=true
BorderProperties.objectwraparound=true
BorderProperties.scan=false

[map]
WWWWWWWWWWWWWWWWWWWWWWWWWWWWWWWWWWWWWWWW
WPwwwwwww.waw............ww.wwwwwwwwwawW
W.........w.w.w.w.w.wwww.ww.......waw.wW
W...w.ww.ww.w.w.w.wwwa...ww.wwww..w.w.wW
W.www.w.....w.wawwwwwwww.ww...aww.w.w.wW
W..aw.ww.wwww.www..w.....ww.wwwww.....wW
W.www.w............w.wwwwww.w.awwwww..wW
W..aw.w.wwww.www.w.w........w.wwwwww.wwW
W.www.w...awawawaw.wwwwww.www....waw.w.W
W..aw.w.wwwwaw.www...aaww.wa..w......w.W
W.www.w....www.....wwwwwwwwwwwwWWWWW.WWW
W..aw.www...aw.ww....w.....wawwW.......W
Ww.w......wwww.wwwwwww.www.wawwW.......W
W..wawww.wwaa..wa....w.waw.w.....ddd...W
Ww.w..a..awwww.wwwwwww.waw.w.wwW.d.dd..W
W..w.www.w..aw.........waw.w.w.W.d..d..W
Ww.waaa..wawwwwww.wwwwwwaw.w.w.W.dX.d..W
W..wwwww.aw.wwwwwaaaaw..a....w.W.d..d..W
W....waw.ww.wwwwwwwwww.wwwwwww.W.d.dd..W
W..www.w....wawawawwawWWWWWWWWWW.ddd...W
Ww.....ww..............................W
WWWWWWWWWWWWWWWWWWWWWWWWWWWWWWWWWWWWWWWW
[/map]
[/cave]

[cave]
Name=Cave 07
IntermissionProperties.instantlife=true
Intermission=false
IntermissionProperties.rewardlife=false
Size=40 22 0 0 39 21
Colors=Atari00 Atari00 Atari0a Atari7c Atariea Atariea Atariea
DiamondsRequired=90 90 90 90 90
CaveTime=95 95 95 95 95
CaveScheduling=bd2ckatari
PALTiming=true
FrameTime=120 120 120 120 120
CaveDelay=6 6 6 6 6
TimeValue=1 1 1 1 1
DiamondValue=2 0
RandSeed=0 0 0 0 0
ActiveGuyIsFirst=false
AmoebaProperties.immediately=false
MagicWallTime=0 0 0 0 0
MagicWallProperties.convertamoeba=false
SlimePermeabilityC64=56 56 56 56 56
BorderProperties.lineshift=true
BorderProperties.objectwraparound=true
BorderProperties.scan=false

[map]
WWWWWWWWWWWWWWWWWWWWWWWWWWWWWWWWWWWWWWWW
WrrddrrWdddddWdddddWrddddWrddddWdddddWXW
WrrddrrWddrddWddrdrWdddddWrddddWdddddW.W
WwdddddWdddddWrddddWdddddWrddddWddrddW.W
WWwdddwWwdddwWwdrdwWwdddwWwdddwWwdrdwW.W
WWWwdwWWWwrwWWWwrwWWWwrwWWWwrwWWWwrwWW.W
WWWWd..WWWr..WWWr..WWWr..WWWr..WWWr..W.W
WWWWdW.WWWdW.WWWrW.WWWrW.WWWrW.WWWrW.W.W
WWWWdW.WWWdW.WWWdW.WWWrW.WWWdW.WWWrW.W.W
WWWWrW.WWWdW.WWWdW.WWWrW.WWWdW.WWWrW.W.W
WWWWrW.WWWdW.WWWdW.WWWrW.WWWdW.WWWrW.W.W
WWWWdW.WWWrW.WWWdW.WWWrW.WWWrW.WWWrW.W.W
WWWWdW.WWWrW.WWWdW.WWWrW.WWWrW.WWWdW.W.W
WWWWrW.WWWrW.WWWdW.WWWdW.WWWrW.WWWdW.W.W
WP...W.....W.....W.....W.....W.....W...W
WWWWsWWWWWsWWWWWsWWWWWsWWWWWsWWWWWsWWW.W
W                                      W
W                                      W
W                                      W
W                                      W
W                                      W
WWWWWWWWWWWWWWWWWWWWWWWWWWWWWWWWWWWWWWWW
[/map]
[/cave]

[cave]
Name=Cave 08
IntermissionProperties.instantlife=true
Intermission=false
IntermissionProperties.rewardlife=false
Size=40 22 0 0 39 21
Colors=Atari00 Atari00 Atari0a Atari00 Atariea Atariea Atariea
DiamondsRequired=96 96 96 96 96
CaveTime=255 255 255 255 255
CaveScheduling=bd2ckatari
PALTiming=true
FrameTime=120 120 120 120 120
CaveDelay=6 6 6 6 6
TimeValue=1 1 1 1 1
DiamondValue=3 3
RandSeed=0 0 0 0 0
ActiveGuyIsFirst=false
AmoebaProperties.immediately=false
AmoebaTime=200 200 200 200 200
MagicWallTime=0 0 0 0 0
MagicWallProperties.convertamoeba=false
SlimePermeabilityC64=0 0 0 0 0
BorderProperties.lineshift=true
BorderProperties.objectwraparound=true
BorderProperties.scan=false

[map]
WWWWWWWWWWWWWWWWWWWWWWWWWWWWWWWWWWWWWWWW
WP.....................................W
WWWWWWWW.WWWWWWWWWWWWWWWWWWWWWWWWWWWWW.W
WXW......w          aWa..W    WWWWWrWW.W
W.W.rwwwww          aWw.wW WW WWWWW....W
W.W...              aW...W WW WWWWWcWW.W
W.WWQW              aWw.wW WW WWWc. WW.W
W.xw W             aaWaaaaaWW WQ. . WW.W
W.WW w            aaaWaaaWWWW w . WWWW.W
W.WWWwWWWWWWWWWWWWWWWWaaaWWWWWw WWWWdW.W
W.Wc c c c c c      WWaaaWWWWWwWWQcWdW.W
W.WWWWWWWWWWWWWWWWWWWWWWWWWWWWQQQQWddW.W
W.W........W..r.r.r.WaaaaaaaWWWWWWWdwW.W
W...WWWWWW.W........WaWWWWWWWWWW...rWW.W
W.WWWaaaaW.WW.W.W.W.WaWWWWWrWWWW..WrWW.W
W.WaaaWWaW.WW.W.W.W.WaWWW......Wr.Wr.W.W
W.W.WWWaaW.WW.W.W.W.WaWWW.WMWW..wQW..W.W
W.W.WWWWWW.WW.W.W.W.WaWWW.WQwWW.w W....W
W.W........WWaWaWaW.Wa.   w wcW.w W..W.W
W.WWWWWWWWWWWWWWWWW.WWWWWWWWWWWWWWWWWW.W
W......................................W
WWWWWWWWWWWWWWWWWWWWWWWWWWWWWWWWWWWWWWWW
[/map]
[/cave]

[cave]
Name=Cave 09
IntermissionProperties.instantlife=true
Intermission=false
IntermissionProperties.rewardlife=false
Size=40 22 0 0 39 21
Colors=Atari00 Atari00 Atari38 Ataric6 Atariea Atariea Atariea
DiamondsRequired=3 3 3 3 3
CaveTime=118 118 118 118 118
CaveScheduling=bd2ckatari
PALTiming=true
FrameTime=180 180 180 180 180
CaveDelay=9 9 9 9 9
TimeValue=1 1 1 1 1
DiamondValue=99 84
RandSeed=0 0 0 0 0
ActiveGuyIsFirst=false
AmoebaProperties.immediately=false
MagicWallTime=0 0 0 0 0
MagicWallProperties.convertamoeba=false
SlimePermeabilityC64=0 0 0 0 0
BorderProperties.lineshift=true
BorderProperties.objectwraparound=true
BorderProperties.scan=false

[map]
WWWWWWWWWWWWWWWWWWWWWWWWWWWWWWWWWWWWWWWW
WPxww......wrw.w w w wQw wdww w . w wrXW
W.xww.wwww.....w w wQw wQwdww w w w wr.W
WQ  w.QQQwwwww.w wQw w w wdww . wQw wr.W
W w w.QQQwwwww.wQw w w w wdww w w w wr.W
W   w.QQQwwwww..............w w w w wr.W
W.xww.QQQwwwwwwwwwwwwwwwwwW.w w w w ...W
W   w.QQQww               w.w w . w wr.W
W w w.wwwww wwwwwwwwwwwww w.w w w . wr.W
W  cw......             w w.wQ. w w wr.W
Wwx.wwwwwwwwwwwwwwwwwww wcw.w w w . wr.W
W   w       Q    Q    w w w.w w w w ...W
W w w      Q    Q     w wcw.w w w w wr.W
W  Qw               c w w w.w . w w wr.W
Wwx.w                 w   w.w wQw w wr.W
W   w  c           c  wQw w.w w w w wr.W
W w w     Q         Q w w w.w w . w wr.W
W  cw  c      c       w w w.w w w wQwr.W
Wwx.w      Q      c c wQw w.w w w w wr.W
Wxx.w  c  c           w w w.w w w w wr.W
Wxx...w               .   w.. w w w ...W
WWWWWWWWWWWWWWWWWWWWWWWWWWWWWWWWWWWWWWWW
[/map]
[/cave]

[cave]
Name=Cave 10
IntermissionProperties.instantlife=true
Intermission=false
IntermissionProperties.rewardlife=false
Size=40 22 0 0 39 21
Colors=Atari00 Atari72 Ataric6 Atari7c Atariea Atariea Atariea
DiamondsRequired=1 1 1 1 1
CaveTime=25 25 25 25 25
CaveScheduling=bd2ckatari
PALTiming=true
FrameTime=80 80 80 80 80
CaveDelay=4 4 4 4 4
TimeValue=1 1 1 1 1
DiamondValue=99 99
RandSeed=0 0 0 0 0
ActiveGuyIsFirst=false
AmoebaProperties.immediately=false
AmoebaTime=255 255 255 255 255
MagicWallTime=255 255 255 255 255
MagicWallProperties.convertamoeba=false
SlimePermeabilityC64=0 0 0 0 0
BorderProperties.lineshift=true
BorderProperties.objectwraparound=true
BorderProperties.scan=false

[map]
WWWWWWWWWWWWWWWWWWWWWWWWWWWWWWWWWWWWWWWW
WP.....................................W
Wr.WWWWWWWWWWWWWWWWWWWWWWWWWWWWWWWWWWW.W
W..xWWWWWaWWWWWWWaWWWWWWWaWWWWWWWaWWWW.W
W WWWWWWW WWWWWWW WWWWWWW WWWWWWW WWWW.W
W WWWWWWW WWWWWWW WWWWWWW WWWWWWW WWWW.W
Wc. WWW   WWWWW   WWWWW   WWWWWWW WWWW.W
WW. WWW W WWWWW W WWWWW W WWWWWWW WWWW.W
WWWc.WW W WWWWW W WWWWW W WWWWW   WWWW.W
WWWW. W WMWWWWW WMWWWWW WMWWWWW W WWWW.W
WWWWw W W WWWWW W WWWWW WcWWWWW W WWWW.W
WWW .cW Wc. . W Wc. . W W . . W WMWWWW.W
WWW .WW WW. . W WW. . W WW. . W WcWWWW.W
WW.cWWW WWWc. W WWWc. W WWWc. W W . WW.W
W .WWWW WWWW. W WWWW. W WWWW. W WW. WW.W
W w WWW WWWWW W WWWWW W WWWWW W WWW WW.W
Wc. WWW WWWWWM  WWWWWM  WWWWWM  WWW WW.W
WW. WWW WWWWw wWWWWWw wWWWWWw wWWWWMWW.W
WWWM    WWWWwQwcWWWWwQwcWWWWwQwcWWW WW.W
WWw wWWWWWWWWWWWWWWWWWWWWWWWWWWWWWWMWW.W
WWwQwcWWX.......................... ...W
WWWWWWWWWWWWWWWWWWWWWWWWWWWWWWWWWWWWWWWW
[/map]
[/cave]

[cave]
Name=Cave 11
IntermissionProperties.instantlife=true
Intermission=false
IntermissionProperties.rewardlife=false
Size=40 22 0 0 39 21
Colors=Atari00 Atari06 Atari9a Atari72 Atari0f Atari0f Atari0f
DiamondsRequired=80 80 80 80 80
CaveTime=155 155 155 155 155
CaveScheduling=bd2ckatari
PALTiming=true
FrameTime=120 120 120 120 120
CaveDelay=6 6 6 6 6
TimeValue=1 1 1 1 1
DiamondValue=3 2
RandSeed=0 0 0 0 0
ActiveGuyIsFirst=false
AmoebaProperties.immediately=false
AmoebaTime=255 255 255 255 255
MagicWallTime=0 0 0 0 0
MagicWallProperties.convertamoeba=false
SlimePermeabilityC64=0 0 0 0 0
BorderProperties.lineshift=true
BorderProperties.objectwraparound=true
BorderProperties.scan=false

[map]
WWWWWWWWWWWWWWWWWWWWWWWWWWWWWWWWWWWWWWWW
W..............WdWWcccWrrrrrrrrrrrrWWWrW
W.WWWWWWWWWWWW....WccWW.rrrrrrrrrrrWW..W
W.WWWWWWWWWWWW WWWWcWW  wrrrrrrrrrrWWW W
W.          aW WaWccW  wwwrrrrrrrrrWWW W
W.WWWWWWWWWWWW W WWcW wwwwwrrrrrrrrWWw W
W.          aW W WccW  wwwwwrrrrrrrW w W
W.WWWWWWWWWWWW   WWcWw  wwwwwrrrrWWW w W
W.          aW W WWcWww  wwwwwrrrWcw W W
W.WWWWWWWWWWWW WXWrcWwww  wwwwwrrW w W W
W.          aW WWW.WWwwww  wwwwrWw wcW W
W.WWWWWWWWWWWWaWW           WWwr w WWW W
W.          aWWW. wwWWWWWWWWW  MQw WWW W
W.WWWWWWWWWWWWW..MwwWrWWWWWW   w WWWWW W
W.          aW..wwwwWP..WWWW   WWWWWWW W
W.WWWWWWWWWWWW.WWWWWWMW.xWWW MMWWWWWWW W
W.          aW.W    wQw....W     WWWrW W
W.WWWWWWWWWWWW.W WWWW WWWW.W     WW..W W
W.          aW.W W  wWwQcW.W     WWW.w W
W.WWWWWWWWWWWW.W W W   WWW.WWWWWWWWW.w W
W..............W   WWWWWWW...........w W
WWWWWWWWWWWWWWWWWWWWWWWWWWWWWWWWWWWWWWWW
[/map]
[/cave]

[cave]
Name=Cave 12
IntermissionProperties.instantlife=true
Intermission=false
IntermissionProperties.rewardlife=false
Size=40 22 0 0 39 21
Colors=Atari00 Atari00 Atari0f Atari04 Atari0f Atari0f Atari0f
DiamondsRequired=70 70 70 70 70
CaveTime=255 255 255 255 255
CaveScheduling=bd2ckatari
PALTiming=true
FrameTime=120 120 120 120 120
CaveDelay=6 6 6 6 6
TimeValue=1 1 1 1 1
DiamondValue=1 2
RandSeed=0 0 0 0 0
ActiveGuyIsFirst=false
AmoebaProperties.immediately=false
MagicWallTime=0 0 0 0 0
MagicWallProperties.convertamoeba=false
SlimePermeabilityC64=60 60 60 60 60
BorderProperties.lineshift=true
BorderProperties.objectwraparound=true
BorderProperties.scan=false

[map]
WWWWWWWWWWWWWWWWWWWWWWWWWWWWWWWWWWWWWWWW
WWWwrrrrWWWWWdWWWWWWrWWWWWWdWWWWWWWrWWWW
WWWWwrrrWWWWWcWWWWWP.WWWWWWcWWWWWWrrWWWW
W....wQrWWWcsdWWWWWWcWWWWWWds WWWWQrWWWW
W.WWW wrWQs sdWWWWcs scWWWWds WWWWrr   W
W.WWWsWrs s WdWWcs s s scWWdWsWWWWQWW.sW
W....cWrs WWWdcs s sss s scdW WWWWrWW.cW
WWWWW WWssWWWs s WWWsWWW s sWsWWWWQWW. W
WWWWWsWWw WWWs WWWWW WWWWW sW WWWWrWWs W
WWWWWcWWWMWWWWsWWWWWsWWWWWsWWsWWWWQWWcWW
WWWWW WWW  WWW WrrrW WWWWW WW WWWWrsW WW
WWWWWsWWWw  WWsWwrrWsWW...sWWcsxWWQsW sW
WWWWW WWWWw  W  dwrr  W.W..WWssWWWrsWWcW
WWWWWcWWWWWw Wr .Wwrw  .WWsWW  WWWssWW W
WWWW w WWWW  Wrw  Wrrw  WW WWw  WWrsWs W
WWW  w  WWW d.rWw Wrrrw .WsWWWw  WQsWcWW
WWW wWw ..WsW.wWWssrrrws.W W...w WrsW WW
WWWsWWWsW.s s...s srrd. .WsW.W..sWQsW sW
WWWcsQsc..sQsw WWQsww.WsWW W..W.QsrsWWcW
WWW W W WWWWW    W  W.sQssQsW.WW srsWW W
WWWWW WWWWWW     WMMWWs ss s..WWWWWWXs W
WWWWWWWWWWWWWWWWWWWWWWWWWWWWWWWWWWWWWWWW
[/map]
[/cave]
[/game]
[/BDCFF]
