[BDCFF]
Version=0.5

[game]
Name=Boulder Dash Dig Dug 001
Levels=5

[cave]
Name=Cave 01
IntermissionProperties.instantlife=true
Intermission=false
IntermissionProperties.rewardlife=false
Size=40 22 0 0 39 21
Colors=Atari00 Atari00 Atari72 Atari34 Atari9a Atari9a Atari9a
DiamondsRequired=99 99 99 99 99
CaveTime=999 999 999 999 999
CaveScheduling=bd2ckatari
PALTiming=true
FrameTime=80 80 80 80 80
CaveDelay=0 0 0 0 0
TimeValue=1 1 1 1 1
DiamondValue=99 99
RandSeed=0 0 0 0 0
ActiveGuyIsFirst=false
AmoebaProperties.immediately=false
MagicWallTime=35 35 35 35 35
MagicWallProperties.convertamoeba=false
SlimePermeabilityC64=16 16 16 16 16
BorderProperties.lineshift=true
BorderProperties.objectwraparound=true
BorderProperties.scan=false

[map]
WWWWWWWWWWWWWWWWWWWWWWWWWWWWWWWWWWWWWWWW
WddddddddddddddXdddddddddddddddddddddddW
WdddddddddddddddddddddddddddddddcddddddW
WdddddddddddddddddddddddcddddcdddddddddW
WdddcddcdddcddcddcddcddddddddddddddcdddW
WddddddddddddddddddddcddddcddddddddddddW
WddddddddddddddddddddddddddddddcdddddcdW
WddcddcddcddcdddcddcddddcddddddddddddddW
WdddddddddddddddddddddcddddddcdddddcdddW
WddddddcddcdddcdddcddddddddddddddddddddW
WddddcddddddddddddddddcddcddddddddddcddW
WdddddddcdddcdddcddcddddddddddcddddddddW
WddddddddddddddddddddddddddddddddcdddddW
WdddddddddddddddddddddddddddcddddddcdddW
WWWWWWWWWWWWWWWWWWWWWWWWWWWdddcddddddcdW
WPMMddMddMMdrrdMMddM MddMMWdddddcddddddW
WdM MdMdMddd  dM MdM MdM  WddddddddcdddW
WdM MdMdMdddMMdM MdM MdM  WddddddddddddW
WdM MdMdMdMd  dM MdM MdM MWddddddddddddW
WdMMddMddMMddddMMddMMMddMMWWWWWWWWWWWWdW
WddddddddddddddddddddddddddddddddddddddW
WWWWWWWWWWWWWWWWWWWWWWWWWWWWWWWWWWWWWWWW
[/map]
[/cave]

[cave]
Name=Cave 02
IntermissionProperties.instantlife=true
Intermission=false
IntermissionProperties.rewardlife=false
Size=40 22 0 0 39 21
Colors=Atari00 Atari00 Atari42 Atari38 Atari9a Atari9a Atari9a
DiamondsRequired=99 99 99 99 99
CaveTime=999 999 999 999 999
CaveScheduling=bd2ckatari
PALTiming=true
FrameTime=80 80 80 80 80
CaveDelay=0 0 0 0 0
TimeValue=1 1 1 1 1
DiamondValue=99 99
RandSeed=0 0 0 0 0
ActiveGuyIsFirst=false
AmoebaProperties.immediately=false
MagicWallTime=0 0 0 0 0
MagicWallProperties.convertamoeba=false
SlimePermeabilityC64=0 0 0 0 0
BorderProperties.lineshift=true
BorderProperties.objectwraparound=true
BorderProperties.scan=false

[map]
WWWWWWWWWWWWWWWWWWWWWWWWWWWWWWWWWWWWWWWW
WddddddddddddddddddddddddddddddddddddwXW
WdFFFdFFFdFFFdFFFdFFFdFFFdFdFdddFddddwdW
WdFdddFdddFdddFdddFdFdFdFdFdFFddFddddwdW
WdFFFdFdddFFFdFFddFFddFFddFdFdFdFddddwdW
WdddFdFdddddFdFdddFdFdFdFdFdFddFFddddwdW
WdFFFdFFFdFFFdFFFdFdFdFFFdFdFdddFddddwdW
WddddddddddddddddPdddddddddddddddddddwdW
WdddddddddFFFddFddFdddFFFddFddFdddFddwdW
WdddddddddddFdFdFdFddddFddFdFdFFddFddwdW
WddddddddddFddFdFdFddddFddFFFdFdFdFddwdW
WdddddddddFdddFdFdFddddFddFdFdFddFFddwdW
WdddddddddFFFddFddFFFddFddFdFdFdddFddwdW
WddddddddddddddddddddddddddddddddddddwdW
WdWWWWWWWWWWWWWWWWWWWWWWWWWWWWWWWWWWWWdW
Wdddddddddr  .r Qwwwwwwwwwwwwwww.r....rW
Wwwwwwwwwwww ... wdddddddddddddw..r..r.W
Wddddddddddw ... wdddwwddddddwww...rr..W
Wddddddddddw ... w..r  .....r  w..r..r.W
Wddddddddddw ... w.... ....... w.r....rW
WddddddddddwQ... w....c.......Qw.......W
WWWWWWWWWWWWWWWWWWWWWWWWWWWWWWWWWWWWWWWW
[/map]
[/cave]

[cave]
Name=Cave 03
IntermissionProperties.instantlife=true
Intermission=false
IntermissionProperties.rewardlife=false
Size=40 22 0 0 39 21
Colors=Atari00 Atari00 Atari42 Atari38 Atari9a Atari9a Atari9a
DiamondsRequired=99 99 99 99 99
CaveTime=999 999 999 999 999
CaveScheduling=bd2ckatari
PALTiming=true
FrameTime=80 80 80 80 80
CaveDelay=0 0 0 0 0
TimeValue=1 1 1 1 1
DiamondValue=99 99
RandSeed=0 0 0 0 0
ActiveGuyIsFirst=false
AmoebaProperties.immediately=false
MagicWallTime=0 0 0 0 0
MagicWallProperties.convertamoeba=false
SlimePermeabilityC64=0 0 0 0 0
BorderProperties.lineshift=true
BorderProperties.objectwraparound=true
BorderProperties.scan=false

[map]
WWWWWWWWWWWWWWWWWWWWWWWWWWWWWWWWWWWWWWWW
WPdddddddddddddddddddddddddddddddddddd.W
Wddddddrdddddddddr.rdWddddrdddddddddrd.W
Wdddddd.ddddddddd..cdWdddd.ddddddddd...W
Wddwwww wwwwdwwww .ddWwwww wwwwdwwww ..W
Wddw    wddddw    .ddWw d  wddddw    ..W
Wddw    wddddwc   .ddWwc   wddddwc   ..W
Wddwwww wddddwwww dddWwwww wddddwwww ..W
Wdddddw wdddddddw .ddW...wdwdddddddwd..W
Wdddddwcwdddddddw..ddW...wdwdddddddwd..W
Wddwwwwrwwwwdwwwwr.ddWwwwwdwwwwdwwwwdd.W
Wdddddd.ddddddddd..ddWddddddddddWddddd.W
Wddwwww wwwwdwwww .d.Wwwwwdwwwwdwwww.d.W
Wddw    wddddw    .d.Ww    wddddw d  d.W
Wddwc   wddddwc   .d.Wwc   wddddwc   d.W
Wddwwww wddddwwww .d.Wwwww wddddwxww d.W
Wdddddw wdddddddwddddW...w wdddddddw d.W
Wdddddw wdddddddwddddW...w wdddddddw d.W
Wddwwww.wwwwdwwwwddddWwwwwdwwwwdwwwwdd.W
WddddddddddddddddddddWdddddddddddddddd.W
WddddddddddddddddddddWddddddddddddddddXW
WWWWWWWWWWWWWWWWWWWWWWWWWWWWWWWWWWWWWWWW
[/map]
[/cave]

[cave]
Name=Cave 04
IntermissionProperties.instantlife=true
Intermission=false
IntermissionProperties.rewardlife=false
Size=40 22 0 0 39 21
Colors=Atari00 Atari00 Atari42 Atarif4 Atari9a Atari9a Atari9a
DiamondsRequired=58 58 58 58 58
CaveTime=80 80 80 80 80
CaveScheduling=bd2ckatari
PALTiming=true
FrameTime=160 160 160 160 160
CaveDelay=8 8 8 8 8
TimeValue=1 1 1 1 1
DiamondValue=2 2
RandSeed=0 0 0 0 0
ActiveGuyIsFirst=false
AmoebaProperties.immediately=false
MagicWallTime=0 0 0 0 0
MagicWallProperties.convertamoeba=false
SlimePermeabilityC64=0 0 0 0 0
BorderProperties.lineshift=true
BorderProperties.objectwraparound=true
BorderProperties.scan=false

[map]
WWWWWWWWWWWWWWWWWWWWWWWWWWWWWWWWWWWWWWWW
WXwwwwwwwwwwwwwwwwwwwwwwwwwwwwwwwwwwww.W
W                                    dxW
Wwwwwwwwwwwwwwwwwwwwwwwwwwwwwwwwwww wwdW
W                                     dW
W wwwwwwwwwwwwwwwwwwwwwwwwwwwwwwwwwwwwdW
W                                    dxW
W..rr....rr....rrwwwwwwwwwwwwwwwwww wwdW
W.r..r..r..r..r..xd                  ddW
Wr....rr....rr...xd..................w.W
Wwwwwwwwwwwwwwwwwwd..................w.W
Wrrrrrrrrrrrrrrrrrd..QQQQQQQQQQQQQQQQQQW
Wdddddddddddddddddd..wwwwwwwwwwwwwwwwwQW
Wd...................w  r....QQQQQQQQwQW
Wd.QQQ..Q...Q..QQQrrrw ......Q......QwQW
Wd...Q.Q.Q.Q.Q...Qrrrw .WWW.WWW.WWW..wQW
Wd..Q..Q.Q.Q.Q..QQrrrw .Wd..Wd..Wd...wQW
Wd.Q...Q.Q.Q.Q...Q...w .WWW.Wd..WWW..wQW
Wd.QQQ..Q...Q..QQQ...w ..dW.Wd...dW..wQW
Wd...................w .WWW.WWW.WWW..wQW
Wddddddddddddddddd...wQ.............PwQW
WWWWWWWWWWWWWWWWWWWWWWWWWWWWWWWWWWWWWWWW
[/map]
[/cave]

[cave]
Name=Intermission 05
IntermissionProperties.instantlife=true
Intermission=true
IntermissionProperties.rewardlife=false
Size=40 22 0 0 19 11
Colors=Atari00 Atari00 Atari04 Ataric6 Atari9a Atari9a Atari9a
DiamondsRequired=1 1 1 1 1
CaveTime=20 20 20 20 20
CaveScheduling=bd2ckatari
PALTiming=true
FrameTime=100 100 100 100 100
CaveDelay=5 5 5 5 5
TimeValue=1 1 1 1 1
DiamondValue=99 50
RandSeed=0 0 0 0 0
ActiveGuyIsFirst=false
AmoebaProperties.immediately=false
MagicWallTime=0 0 0 0 0
MagicWallProperties.convertamoeba=false
SlimePermeabilityC64=0 0 0 0 0
BorderProperties.lineshift=true
BorderProperties.objectwraparound=true
BorderProperties.scan=false

[map]
WWWWWWWWWWWWWWWWWWWWWWWWWWWWWWWWWWWWWWWW
Hd................xWWWWWWWWWWWWWWWWWWWWW
Wx................dWWWWWWWWWWWWWWWWWWWWW
Wx.wwwwwwwwwwwwwwwxWWWWWWWWWWWWWWWWWWWWW
Ww................xWWWWWWWWWWWWWWWWWWWWW
Wwwwwwwwwwwwwwwww.xWWWWWWWWWWWWWWWWWWWWW
Wx.................WWWWWWWWWWWWWWWWWWWWW
Wx.wwwwwwwwwwwwwwwxWWWWWWWWWWWWWWWWWWWWW
Ww................xWWWWWWWWWWWWWWWWWWWWW
Wwwwwwwwwwwwwwwww.xWWWWWWWWWWWWWWWWWWWWW
WxP................WWWWWWWWWWWWWWWWWWWWW
WWWWWWWWWWWWWWWWWWWWWWWWWWWWWWWWWWWWWWWW
WWWWWWWWWWWWWWWWWWWWWWWWWWWWWWWWWWWWWWWW
WWWWWWWWWWWWWWWWWWWWWWWWWWWWWWWWWWWWWWWW
WWWWWWWWWWWWWWWWWWWWWWWWWWWWWWWWWWWWWWWW
WWWWWWWWWWWWWWWWWWWWWWWWWWWWWWWWWWWWWWWW
WWWWWWWWWWWWWWWWWWWWWWWWWWWWWWWWWWWWWWWW
WWWWWWWWWWWWWWWWWWWWWWWWWWWWWWWWWWWWWWWW
WWWWWWWWWWWWWWWWWWWWWWWWWWWWWWWWWWWWWWWW
WWWWWWWWWWWWWWWWWWWWWWWWWWWWWWWWWWWWWWWW
WWWWWWWWWWWWWWWWWWWWWWWWWWWWWWWWWWWWWWWW
WWWWWWWWWWWWWWWWWWWWWWWWWWWWWWWWWWWWWWWW
[/map]
[/cave]

[cave]
Name=Cave 06
IntermissionProperties.instantlife=true
Intermission=false
IntermissionProperties.rewardlife=false
Size=40 22 0 0 39 21
Colors=Atari00 Atari00 Atari06 Atari34 Atari9a Atari9a Atari9a
DiamondsRequired=35 35 35 35 35
CaveTime=110 110 110 110 110
CaveScheduling=bd2ckatari
PALTiming=true
FrameTime=200 200 200 200 200
CaveDelay=10 10 10 10 10
TimeValue=1 1 1 1 1
DiamondValue=3 3
RandSeed=0 0 0 0 0
ActiveGuyIsFirst=false
AmoebaProperties.immediately=false
MagicWallTime=0 0 0 0 0
MagicWallProperties.convertamoeba=false
SlimePermeabilityC64=0 0 0 0 0
BorderProperties.lineshift=true
BorderProperties.objectwraparound=true
BorderProperties.scan=false

[map]
WWWWWWWWWWWWWWWWWWWWWWWWWWWWWWWWWWWWWWWW
Wwddddddw  r..xdd.c      c    c     cwXW
Wwddddddw ....xdd.c      c    c     cwdW
Wwddddddw ....xdddc      c    c     cwdW
Ww......w ....xddd..........w.........dW
Wx......w .....ddddd..................dW
Wx......wQ..wwwwwwwwwwwwwwwwwwwwwwwwwwdW
Wx.......ww...........................xW
Wwwwwwwwwwwwwwwwwwwwwwwwwwwwwwwwwwwww.xW
W...............................x...w.xW
W.xwwwwwwwwwwwwwwwwwwwwwwwwwwww.w.w.w.xW
W......xwwwwwwwwwwwwwwwwwwwwQ.w.w.w.w.xW
Wwwwww.xwwwQ r..........r  wQ.w.w.w.w.xW
W......xwww .............. wQ.w.w.w.w.xW
W.wwwwwwwww .WWW.WWW.WWW.. wQ.w.w.w.w.xW
W......xwww .W...W...W.... wQ.w.w.w.w.xW
Wwwwww.xwww .WWW.W.P.WWW.. wQ.w.w.w.w.xW
W......xwww ...W.W.....W.. wQ.w.w.w.w.xW
W.wwwwwwwww .WWW.WWW.WWW.W wQ.w.w.w.w.xW
W.........w ..............QwQ.w.w.w.w.xW
W.........wwwwwwwwwwwwwwwwwwQ.x...w...xW
WWWWWWWWWWWWWWWWWWWWWWWWWWWWWWWWWWWWWWWW
[/map]
[/cave]

[cave]
Name=Cave 07
IntermissionProperties.instantlife=true
Intermission=false
IntermissionProperties.rewardlife=false
Size=40 22 0 0 39 21
Colors=Atari00 Atari00 Atarif4 Atari42 Atari9a Atari9a Atari9a
DiamondsRequired=99 99 99 99 99
CaveTime=175 175 175 175 175
CaveScheduling=bd2ckatari
PALTiming=true
FrameTime=160 160 160 160 160
CaveDelay=8 8 8 8 8
TimeValue=1 1 1 1 1
DiamondValue=2 2
RandSeed=0 0 0 0 0
ActiveGuyIsFirst=false
AmoebaProperties.immediately=false
MagicWallTime=0 0 0 0 0
MagicWallProperties.convertamoeba=false
SlimePermeabilityC64=0 0 0 0 0
BorderProperties.lineshift=true
BorderProperties.objectwraparound=true
BorderProperties.scan=false

[map]
WWWWWWWWWWWWWWWWWWWWWWWWWWWWWWWWWWWWWWWW
Wwwwwwwwwwww..xdddddddddddddddddddddddXW
Wwrrrrrrrrrw..w.......................xW
Wwcccccccccw..wwwwwwwwwwwwwwwwwwwwwww..W
Wwcccccccccw..x........................W
W.wrcccccrw...x.wwwwwwwwwwwwwwwwwwwwww.W
W..wcccccw....w.......................xW
W...wrcrw.....wwwwwwwwwwwwwwwwwwwwwww..W
W....wrwr.....x........................W
W......rr.....x.wwwwwwwwwwwwwwwwwwwwww.W
WP...........rw.......................xW
W...w...w.....wwwwwwwwwwwwwwwwwwwwwww..W
W..w     w..r.x........................W
W.w       w...x.wwwwwwwwwwwwwwwwwwwwww.W
Ww         w..w.......................xW
Ww         w.rwwwwwwwwwwwwwwwwwwwwwww..W
Ww         w..x........................W
Ww         w..x.wwwwwwwwwwwwwwwwwwwwww.W
Ww         w..w.......................xW
Wwaaaaaaaaaw..wwwwwwwwwwwwwwwwwwwwwww..W
Wwwwwwwwwwwx...........................W
WWWWWWWWWWWWWWWWWWWWWWWWWWWWWWWWWWWWWWWW
[/map]
[/cave]

[cave]
Name=Cave 08
IntermissionProperties.instantlife=true
Intermission=false
IntermissionProperties.rewardlife=false
Size=40 22 0 0 39 21
Colors=Atari00 Atari00 Atari34 Atari38 Atariea Atariea Atariea
DiamondsRequired=70 70 70 70 70
CaveTime=230 230 230 230 230
CaveScheduling=bd2ckatari
PALTiming=true
FrameTime=200 200 200 200 200
CaveDelay=10 10 10 10 10
TimeValue=1 1 1 1 1
DiamondValue=1 2
RandSeed=0 0 0 0 0
ActiveGuyIsFirst=false
AmoebaProperties.immediately=false
MagicWallTime=0 0 0 0 0
MagicWallProperties.convertamoeba=false
SlimePermeabilityC64=0 0 0 0 0
BorderProperties.lineshift=true
BorderProperties.objectwraparound=true
BorderProperties.scan=false

[map]
WWWWWWWWWWWWWWWWWWWWWWWWWWWWWWWWWWWWWWWW
WWWWWWWW.....cdrddWW.d.ddWW    QWWWQcWWW
WWWdWWW.......WWWd.WdWW.WW       WWWdWWW
WWW.xW ..  .Q..WWW.drW.dW         WW..WW
WWW..c .. r.r...WWW.dddW           WW.WW
WWWW.. Qc .......WWWdWW             ..WW
WW..r...rrr........ddW               WWW
WW.................WW .               WW
W................Qr..             .    W
W...rr.r..........P.X                  W
W....r.r......r...WWWW                 W
W................Wdd.dW.               W
W.........r.....WWWWdWWW               W
W.r............WWQdW.WWWW              W
WW............WWWW.W.WWWWW Q.         WW
WWW..........WW.d.dd..ddWWW      .   WWW
WWWW..........WWWWdWdWdWWW          WWWW
WW.............WWWWWdW.WW.         WWQWW
WW.WWW..........d.WW.W.WQ       . WWQcWW
Wx.dWWW........WWd.WdWddW        QW.dWWW
WWWWWWWW......WWWWdd.WW.dW .    W...WWWW
WWWWWWWWWWWWWWWWWWWWWWWWWWWWWWWWWWWWWWWW
[/map]
[/cave]

[cave]
Name=Cave 09
IntermissionProperties.instantlife=true
Intermission=false
IntermissionProperties.rewardlife=false
Size=40 22 0 0 39 21
Colors=Atari00 Atari00 Atari9a Ataric6 Atariea Atariea Atariea
DiamondsRequired=99 99 99 99 99
CaveTime=255 255 255 255 255
CaveScheduling=bd2ckatari
PALTiming=true
FrameTime=80 80 80 80 80
CaveDelay=0 0 0 0 0
TimeValue=1 1 1 1 1
DiamondValue=11 96
RandSeed=0 0 0 0 0
ActiveGuyIsFirst=false
AmoebaProperties.immediately=false
MagicWallTime=0 0 0 0 0
MagicWallProperties.convertamoeba=false
SlimePermeabilityC64=24 24 24 24 24
BorderProperties.lineshift=true
BorderProperties.objectwraparound=true
BorderProperties.scan=false

[map]
WWWWWWWWWWWWWWWWWWWWWWWWWWWWWWWWWWWWWWWW
WP.....................r....rrrrrrrrr..W
Wrrrrrrrrrrrrrrrrr...w.................W
WMMMMMMMMMMMMMMMMw....w................W
WQQQQQQQQQQQQQQQQw.....w...............W
WQrrrrrrrrrrrrrrQw......w..............W
WQccccccccccccccQr.......w.............W
WQccccccccccccccQ.........w............W
WQccccccccccccccQX.........w...........W
WQccccccccccccccQw..........w..........W
WQccccccccccccccQw..r........w.........W
WQQQQQQQQQQQQQQQQw.. ..................W
Wwwwwwwwwwwwwwwwww..c..rrrr............W
W.QQQ...... .. . ...Q..................W
W.......... . .. ..QcQ.................W
W.... ..... .. ...Qc.cQ....WWW.WWW.WWW.W
W   w wwwww w ...Qc...cQ...W...W...W...W
W   waaaaaaaw... c.....cQ..WWW.W...WWW.W
W   wa.x.x.aw . c...x...cQ...W.W.....W.W
W   wax.x.xaw..cccccxcccccQWWW.WWW.WWW.W
W   waaaaaaa  .  QQQQQQQQQ.............W
WWWWWWWWWWWWWWWWWWWWWWWWWWWWWWWWWWWWWWWW
[/map]
[/cave]

[cave]
Name=Intermission 10
IntermissionProperties.instantlife=true
Intermission=true
IntermissionProperties.rewardlife=false
Size=40 22 0 0 19 11
Colors=Atari00 Atari00 Atari7c Atari42 Atari9a Atari9a Atari9a
DiamondsRequired=68 68 68 68 68
CaveTime=75 75 75 75 75
CaveScheduling=bd2ckatari
PALTiming=true
FrameTime=80 80 80 80 80
CaveDelay=2 2 2 2 2
TimeValue=1 1 1 1 1
DiamondValue=20 20
RandSeed=0 0 0 0 0
ActiveGuyIsFirst=false
AmoebaProperties.immediately=false
AmoebaTime=233 233 233 233 233
MagicWallTime=238 238 238 238 238
MagicWallProperties.convertamoeba=false
SlimePermeabilityC64=0 0 0 0 0
BorderProperties.lineshift=true
BorderProperties.objectwraparound=true
BorderProperties.scan=false

[map]
WWWWWWWWWWWWWWWWWWWWWWWWWWWWWWWWWWWWWWWW
W.r  w.a..ccc..a.ccWWWWWWWWWWWWWWWWWWWWW
W... w.a..ccc..a.ccWWWWWWWWWWWWWWWWWWWWW
W... w.a..ccc..a.ccWWWWWWWWWWWWWWWWWWWWW
WP..Qw.a..ccc..a.ccWWWWWWWWWWWWWWWWWWWWW
WWWWWWWWWWWWWWWWWW.WWWWWWWWWWWWWWWWWWWWW
WQQQ.QQQ.QQQW.QQ.W.WWWWWWWWWWWWWWWWWWWWW
WQ...Q...Q..W.QQ.W.WWWWWWWWWWWWWWWWWWWWW
WQQQ.Q...QQQW.QQ.W.WWWWWWWWWWWWWWWWWWWWW
W..Q.Q.....QW....W.WWWWWWWWWWWWWWWWWWWWW
WQQQ.QQQ.QQQW.QQ.WXWWWWWWWWWWWWWWWWWWWWW
WWWWWWWWWWWWWWWWWWWWWWWWWWWWWWWWWWWWWWWW
WWWWWWWWWWWWWWWWWWWWWWWWWWWWWWWWWWWWWWWW
WWWWWWWWWWWWWWWWWWWWWWWWWWWWWWWWWWWWWWWW
WWWWWWWWWWWWWWWWWWWWWWWWWWWWWWWWWWWWWWWW
WWWWWWWWWWWWWWWWWWWWWWWWWWWWWWWWWWWWWWWW
WWWWWWWWWWWWWWWWWWWWWWWWWWWWWWWWWWWWWWWW
WWWWWWWWWWWWWWWWWWWWWWWWWWWWWWWWWWWWWWWW
WWWWWWWWWWWWWWWWWWWWWWWWWWWWWWWWWWWWWWWW
WWWWWWWWWWWWWWWWWWWWWWWWWWWWWWWWWWWWWWWW
WWWWWWWWWWWWWWWWWWWWWWWWWWWWWWWWWWWWWWWW
WWWWWWWWWWWWWWWWWWWWWWWWWWWWWWWWWWWWWWWW
[/map]
[/cave]

[cave]
Name=Cave 11
IntermissionProperties.instantlife=true
Intermission=false
IntermissionProperties.rewardlife=false
Size=40 22 0 0 39 21
Colors=Atari00 Atari00 Atari72 Atari7c Atari9a Atari9a Atari9a
DiamondsRequired=99 99 99 99 99
CaveTime=130 130 130 130 130
CaveScheduling=bd2ckatari
PALTiming=true
FrameTime=200 200 200 200 200
CaveDelay=10 10 10 10 10
TimeValue=1 1 1 1 1
DiamondValue=0 5
RandSeed=0 0 0 0 0
ActiveGuyIsFirst=false
AmoebaProperties.immediately=false
AmoebaTime=40 40 40 40 40
MagicWallTime=0 0 0 0 0
MagicWallProperties.convertamoeba=false
SlimePermeabilityC64=0 0 0 0 0
BorderProperties.lineshift=true
BorderProperties.objectwraparound=true
BorderProperties.scan=false

[map]
WWWWWWWWWWWWWWWWWWWWWWWWWWWWWWWWWWWWWWWW
W...r  .  r.  r..r......rP....c...accccW
W..... .Q... ....w..........Q.....accacW
W..... . ... ...rw..............r.accacW
Wr.... . ... ...Qw...c..c......Q..accacW
W..... . ... ..r.w..........r.....acwacW
W..... wwrww ...rw..c...c.......c.accacW
Wr....QwFXFwQ....w.r..........c..caccacW
W......wwwww ....w...............caccacW
Wr...............w...r.........Q..accacW
W.......r........w..c...c.r....r..accacW
Wwwwwwwwwwwwwwwwww...r....r...cr..accacW
W..............r..r.c.c..........raccacW
W..............r....r..c.........raccacW
W..................rc...c.r.......accacW
W..rrr.rrr.rrr......c....c........accacW
W..r...r...r........c..r..c..r....accacW
W..rrr.r...rrr......c......c......accacW
W....r.r.....r......c.......c.....accacW
W..rrr.rrr.rrr.r...rc.....r..c....accacW
W...............r...c...r...r.c...accccW
WWWWWWWWWWWWWWWWWWWWWWWWWWWWWWWWWWWWWWWW
[/map]
[/cave]

[cave]
Name=Cave 12
IntermissionProperties.instantlife=true
Intermission=false
IntermissionProperties.rewardlife=false
Size=40 22 0 0 39 21
Colors=Atari00 Atari00 Atari34 Atari38 Atari9a Atari9a Atari9a
DiamondsRequired=99 99 99 99 99
CaveTime=100 100 100 100 100
CaveScheduling=bd2ckatari
PALTiming=true
FrameTime=160 160 160 160 160
CaveDelay=8 8 8 8 8
TimeValue=1 1 1 1 1
DiamondValue=0 1
RandSeed=0 0 0 0 0
ActiveGuyIsFirst=false
AmoebaProperties.immediately=false
AmoebaTime=10 10 10 10 10
MagicWallTime=0 0 0 0 0
MagicWallProperties.convertamoeba=false
SlimePermeabilityC64=255 255 255 255 255
BorderProperties.lineshift=true
BorderProperties.objectwraparound=true
BorderProperties.scan=false

[map]
WWWWWWWWWWWWWWWWWWWWWWWWWWWWWWWWWWWWWWWW
W......................rw.c.ccc.aa.....W
W.....XWWWWWWWWW.......rwa...c.ww..cwW.W
W.....W       WQrWWW....w.ac..w..wcwa..W
W.....W WWW   WW...W....w.ccaw...awWac.W
W.....W W     W QW.W....wcccca..a.cwa..W
W.....W WWW    WWW.W...rw.QQ..aa..W.ac.W
W.....W ddW    ..r.W....wwwwwwca.wccac.W
W.....W WWW   WW.W.W.......rwcc.wWw.c..W
W.....W Q      W.W.WWWWWW...wccw.c.w.c.W
W.....W WWW   WW.W......WW.rwQQc..Wcw..W
W.....W W     dW.WWWWWW..W..wwacacWaWw.W
W.....W W     .W.W......WW..w.wacaWac..W
W.....W W      W...WWWWWW...wQ.wa.Wc.c.W
W.....W WWW    WW...........wac.ccW.c..W
W.....W        WWWWW.......rwa.a.wWaaa.W
W.....W WWW    W...........rwa.c..W..c.W
W.....W W  c   W...........wwa..c.Wwa..W
W.....W WWW    W...........wwcaaaaWwca.W
W....xW   W    W.........w.....c..Wwaa.W
W.....P WWW    .........ww..w ..c.W.cc.W
WWWWWWWWWWWWWWWWWWWWWWWWWWWWWWWWWWWWWWWW
[/map]
[/cave]

[cave]
Name=Cave 13
IntermissionProperties.instantlife=true
Intermission=false
IntermissionProperties.rewardlife=false
Size=40 22 0 0 39 21
Colors=Atari00 Atari00 Atarif4 Atari42 Atari9a Atari9a Atari9a
DiamondsRequired=69 69 69 69 69
CaveTime=105 105 105 105 105
CaveScheduling=bd2ckatari
PALTiming=true
FrameTime=140 140 140 140 140
CaveDelay=7 7 7 7 7
TimeValue=1 1 1 1 1
DiamondValue=3 3
RandSeed=0 0 0 0 0
ActiveGuyIsFirst=false
AmoebaProperties.immediately=false
MagicWallTime=0 0 0 0 0
MagicWallProperties.convertamoeba=false
SlimePermeabilityC64=0 0 0 0 0
BorderProperties.lineshift=true
BorderProperties.objectwraparound=true
BorderProperties.scan=false

[map]
WWWWWWWWWWWWWWWWWWWWWWWWWWWWWWWWWWWWWWWW
WQQQQQQQQQW.........................xwwW
WQrrrrrrQWd.dw..Wd.....F......W..xd.wwwW
WQrFFFrQWwww.dw..Wd.WdFFFdW.dW..xd.dwwwW
WQrFFrQWFFFFw.dw..Wd.W.F.W.dW..xd.dwwwwW
WQrFrQWFFFFFFw.dw..Wd.WWW.dW..xd.dwwwwwW
WQrrQWFFFFFFFFw.dw..Wd.W.dW..xd.dwwwwwwW
WQrQWFFFFFFFFFFw.dw..WdWdW..xd.dwwwwwwwW
WQQWFFFFFFFFFFFFw.dw..WWW..xd.d.......XW
WQWFFFFFFFFFFFFFFw.dw.WWW..xwwwwwwwwwwwW
WWwwwwwwwwwwwwwwwww..wwwww............xW
WWwc            dP.....w......xwwwwww.xW
WQWwwwwwwwwwwwwwwww..wwwwwww..x.......xW
WQQW.dw.dwFFwwwFFwd.wQQQQwd..x..wwwwwwxW
WQrQW.dw.dwFwwwFwd.wQQQQwd..x.........xW
WQrrQW.dw.dwwwwwd.wQQQQwd..x..wwwwwww.xW
WQrFrQW.dw.dwwwd.wQQQQwd..x...........xW
WQrFFrQW.dw.ddd.wQQQQwd..x..wwwwwwwwwwxW
WQrFFFrQW.dw...wQQQQwd..x.............xW
WQrrrrrrQW.dw.wwwwwwww.xddddddddddwww..W
WQQQQQQQQQW............................W
WWWWWWWWWWWWWWWWWWWWWWWWWWWWWWWWWWWWWWWW
[/map]
[/cave]

[cave]
Name=Cave 14
IntermissionProperties.instantlife=true
Intermission=false
IntermissionProperties.rewardlife=false
Size=40 22 0 0 39 21
Colors=Atari00 Atari00 Atari7c Atari38 Atari9a Atari9a Atari9a
DiamondsRequired=8 8 8 8 8
CaveTime=60 60 60 60 60
CaveScheduling=bd2ckatari
PALTiming=true
FrameTime=80 80 80 80 80
CaveDelay=0 0 0 0 0
TimeValue=1 1 1 1 1
DiamondValue=6 6
RandSeed=0 0 0 0 0
ActiveGuyIsFirst=false
AmoebaProperties.immediately=false
MagicWallTime=0 0 0 0 0
MagicWallProperties.convertamoeba=false
SlimePermeabilityC64=0 0 0 0 0
BorderProperties.lineshift=true
BorderProperties.objectwraparound=true
BorderProperties.scan=false

[map]
WWWWWWWWWWWWWWWWWWWWWWWWWWWWWWWWWWWWWWWW
WXw   w   w   w   wPw   w   w   w   w.dW
W w w w w w w w w w w w w w w w w w w.dW
W w w w w w w w w w w w w w w w w w w.dW
W w w w w w w w w w w w w w w w w w w.dW
W w w w w w w w w w w w w w w w w w w.dW
W w w w w w w w w w w w w w w w w w w.dW
W w w w w w w w w w w w w w w w w w w.dW
W w w w w w w w w w w w w w w w w w w.dW
W w w w w w w w w w w w w w w w w w w..W
W w w w w w w w w w w w w w w w w w w  W
W.x.x.x.x.x.x.x.x.w w w w w w w w w w  W
W w w w w w w w w w w w w w w w w w w  W
W w w w w w w w w w w w w w w w w w w  W
W w w w w w w w w w w w w w w w w w w  W
W w w w w w w w w w w w w w w w w w w  W
W w w w w w w w w w w w w w w w w w w  W
W.w.w.w.w.w.w.w.w.w w w w w w w w w w  W
W w w w w w w w w w w w w w w w w w w  W
W w w w w w w w w w w w w w w w w w w  W
W   w   w   w   w     w   w   w   w    W
WWWWWWWWWWWWWWWWWWWWWWWWWWWWWWWWWWWWWWWW
[/map]
[/cave]

[cave]
Name=Intermission 15
IntermissionProperties.instantlife=true
Intermission=true
IntermissionProperties.rewardlife=false
Size=40 22 0 0 19 11
Colors=Atari00 Atari00 Atari38 Atarica Atariea Atariea Atariea
DiamondsRequired=50 50 50 50 50
CaveTime=180 180 180 180 180
CaveScheduling=bd2ckatari
PALTiming=true
FrameTime=160 160 160 160 160
CaveDelay=8 8 8 8 8
TimeValue=1 1 1 1 1
DiamondValue=2 5
RandSeed=0 0 0 0 0
ActiveGuyIsFirst=false
AmoebaProperties.immediately=false
AmoebaTime=255 255 255 255 255
MagicWallTime=0 0 0 0 0
MagicWallProperties.convertamoeba=false
SlimePermeabilityC64=255 255 255 255 255
BorderProperties.lineshift=true
BorderProperties.objectwraparound=true
BorderProperties.scan=false

[map]
WWWWWWWWWWWWWWWWWWWWWWWWWWWWWWWWWWWWWWWW
Wc.c.c.c.c.c.c.aaaaWWWWWWWWWWWWWWWWWWWWW
Wr.c.cXc.c.c.c.....WWWWWWWWWWWWWWWWWWWWW
W..r.c.c.c.c.c.....WWWWWWWWWWWWWWWWWWWWW
W....r.c.c.c.c.....WWWWWWWWWWWWWWWWWWWWW
W......r.c.c.c.....WWWWWWWWWWWWWWWWWWWWW
W........r.c.c.....WWWWWWWWWWWWWWWWWWWWW
W..........r.c.....WWWWWWWWWWWWWWWWWWWWW
W............r.....WWWWWWWWWWWWWWWWWWWWW
W..................WWWWWWWWWWWWWWWWWWWWW
WP.................WWWWWWWWWWWWWWWWWWWWW
WWWWWWWWWWWWWWWWWWWWWWWWWWWWWWWWWWWWWWWW
WWWWWWWWWWWWWWWWWWWWWWWWWWWWWWWWWWWWWWWW
WWWWWWWWWWWWWWWWWWWWWWWWWWWWWWWWWWWWWWWW
WWWWWWWWWWWWWWWWWWWWWWWWWWWWWWWWWWWWWWWW
WWWWWWWWWWWWWWWWWWWWWWWWWWWWWWWWWWWWWWWW
WWWWWWWWWWWWWWWWWWWWWWWWWWWWWWWWWWWWWWWW
WWWWWWWWWWWWWWWWWWWWWWWWWWWWWWWWWWWWWWWW
WWWWWWWWWWWWWWWWWWWWWWWWWWWWWWWWWWWWWWWW
WWWWWWWWWWWWWWWWWWWWWWWWWWWWWWWWWWWWWWWW
WWWWWWWWWWWWWWWWWWWWWWWWWWWWWWWWWWWWWWWW
WWWWWWWWWWWWWWWWWWWWWWWWWWWWWWWWWWWWWWWW
[/map]
[/cave]
[/game]
[/BDCFF]
