[BDCFF]
Version=0.5

[game]
Name=Boulder Dash Ninja 001
Levels=5

[cave]
Name=Cave 01
IntermissionProperties.instantlife=true
Intermission=false
IntermissionProperties.rewardlife=false
Size=40 22 0 0 39 21
Colors=Atari00 Atari00 Atari12 Atari04 Atari0f Atari0f Atari0f
DiamondsRequired=50 50 50 50 50
CaveTime=150 150 150 150 150
CaveScheduling=bd2ckatari
PALTiming=true
FrameTime=140 140 140 140 140
CaveDelay=7 7 7 7 7
TimeValue=1 1 1 1 1
DiamondValue=5 5
RandSeed=0 0 0 0 0
ActiveGuyIsFirst=false
AmoebaProperties.immediately=false
MagicWallTime=0 0 0 0 0
MagicWallProperties.convertamoeba=false
SlimePermeabilityC64=0 0 0 0 0
BorderProperties.lineshift=true
BorderProperties.objectwraparound=true
BorderProperties.scan=false

[map]
WWWWWWWWWWWWWWWWWWWWWWWWWWWWWWWWWWWWWWWW
W.......................r  w...ddd.....W
W......................... w...d.d.QQ..W
W.W...W..W.W...W...W..WW.. w....d.QQQQ.W
W.WW..W..W.WW..W...W.W..W. w...ddd.QQ..W
W.W.W.W..W.W.W.W...W.W..W. w...........W
W.W..WW..W.W..WW...W.WWWW. w....d......W
W.W...W..W.W...W.W.W.W..W. w...d.d.....W
W.W...W..W.W...W.WWW.W..W. w...d.d.QQ..W
WP........................Qw....d.QQQQ.W
WWWWWWWWWWWWWWWWWWWWWWWWWWWW...rrQQQQQQW
W...rrr.............r.wwwww....rd......W
W....Qr....dddddr.....www..w...d.d..d..W
W...d.r.....Qrdd.....rwwwww..r.d.d.....W
W..ddddd.d.d.dddr....rwwww......d......W
W........r......r....rdwwww....rrrw....W
W............r..r...r.ddww...d.dddrww..W
W.r..rd.r...Q.d..d..wwwwwww.d....drr.w.W
W....Q..dd.r..........wwww.d....ddrrr..W
W.r.d.r..........Q.....wddd......drrrr.W
W.......d..r..d.......dddd.....dddrrrrXW
WWWWWWWWWWWWWWWWWWWWWWWWWWWWWWWWWWWWWWWW
[/map]
[/cave]

[cave]
Name=Cave 02
IntermissionProperties.instantlife=true
Intermission=false
IntermissionProperties.rewardlife=false
Size=40 22 0 0 39 21
Colors=Atari00 Atari00 Atari34 Atarif4 Atari0f Atari0f Atari0f
DiamondsRequired=99 99 99 99 99
CaveTime=80 80 80 80 80
CaveScheduling=bd2ckatari
PALTiming=true
FrameTime=120 120 120 120 120
CaveDelay=6 6 6 6 6
TimeValue=1 1 1 1 1
DiamondValue=2 2
RandSeed=0 0 0 0 0
ActiveGuyIsFirst=false
AmoebaProperties.immediately=false
MagicWallTime=0 0 0 0 0
MagicWallProperties.convertamoeba=false
SlimePermeabilityC64=0 0 0 0 0
BorderProperties.lineshift=true
BorderProperties.objectwraparound=true
BorderProperties.scan=false

[map]
WWWWWWWWWWWWWWWWWWWWWWWWWWWWWWWWWWWWWWWW
W..................w  r..w.........w r.W
W..................w ....w.........w ..W
W.ddd..d...d..ddd..w ....w.ddd..dd.w ..W
W.d.d.d.d.d.d...d..w ....wd....d..dw ..W
W..d..d.d.d.d..dd..w ....wd.dd.d..dw ..W
W.d...d.d.d.d...d..w ....wd..d.d..dw ..W
W.ddd..d...d..ddd..w ....w.dd...dd.w ..W
WwwwwwwwwwwwwwwwwwwwQ....wwwwwwwwwwwQ..W
W......................................W
W.....................P............r  .W
Wwwwwwwwwwwwwwwww r..wwwwwwwwwwwwwwww .W
Ww..............w ...w..............w .W
Wwddd..d..ddd...w ...w.ddd..ddd.d.d.w .W
Wwd...d.d.d.d...w ...w.d....d...d.d.w .W
Wwdd..d.d.dd.dddw ...w.d.dd.ddd.ddd.w .W
Wwd...d.d.dd....w ...w.d....d.d...d.w .W
Wwd....d..d.d...w ...w.ddd..ddd...d.w .W
Ww..............w ...w..............w .W
WwwwwwwwwwwwwwwwwQ...wwwwwwwwwwwwwwwwQ.W
WQ               .                  Q.XW
WWWWWWWWWWWWWWWWWWWWWWWWWWWWWWWWWWWWWWWW
[/map]
[/cave]

[cave]
Name=Cave 03
IntermissionProperties.instantlife=true
Intermission=false
IntermissionProperties.rewardlife=false
Size=40 22 0 0 39 21
Colors=Atari00 Atari00 Atarif4 Ataric6 Atari0f Atari0f Atari0f
DiamondsRequired=50 50 50 50 50
CaveTime=150 150 150 150 150
CaveScheduling=bd2ckatari
PALTiming=true
FrameTime=120 120 120 120 120
CaveDelay=6 6 6 6 6
TimeValue=1 1 1 1 1
DiamondValue=9 10
RandSeed=0 0 0 0 0
ActiveGuyIsFirst=false
AmoebaProperties.immediately=false
MagicWallTime=0 0 0 0 0
MagicWallProperties.convertamoeba=false
SlimePermeabilityC64=0 0 0 0 0
BorderProperties.lineshift=true
BorderProperties.objectwraparound=true
BorderProperties.scan=false

[map]
WWWWWWWWWWWWWWWWWWWWWWWWWWWWWWWWWWWWWWWW
W..w.....d.r....w...w.........r........W
W.....w.r...d...dw.........r.dw....d...W
W.Md.M.M.r.r.r.M.X.....wwr.d.dMd.d..r.dW
W...rwc.r.r.M.........M........M.......W
W..w.M.r...rwMrr..M..M....dw.M.w.w...c.W
W..ww...M...w.M.M...M.d.....r...Md.M...W
Wd.M......dMrw.c...w..d..c.....r.......W
Wwd...w..MM...dwr.........w...d........W
Wd.M...Mrww......d......w..M.M.r...r..dW
W.c.d...c..c..M..wr.d....r......c.dd...W
Wcwr.w.r.M.....P.....c......d...w..dd..W
W...M.Md......rw.dr..Mwrc..wM.d......M.W
W..M.dMdr..d.w...d...r.......wr.....wwdW
W.r.d.M.rwr.c.......d.....M.d.ww...wwd.W
W.M..ddM.d.d.r..........dw.w....w.M.r..W
W...w.d.rd.............Mc.M.rM...w.r.r.W
W..cr.Mc.c.d.d.w.w.......d.w...r..M...cW
Ww......r.dMw..wd.d..r....M.....dw.r.w.W
W........d.w......M..d.drM...d.Mw.M.d.wW
W.....w.r.Mw..w.r...dwMd..w..dw..MMd.M.W
WWWWWWWWWWWWWWWWWWWWWWWWWWWWWWWWWWWWWWWW
[/map]
[/cave]

[cave]
Name=Cave 04
IntermissionProperties.instantlife=true
Intermission=false
IntermissionProperties.rewardlife=false
Size=40 22 0 0 39 21
Colors=Atari00 Atari00 Atari72 Atari38 Atari0f Atari0f Atari0f
DiamondsRequired=50 50 50 50 50
CaveTime=80 80 80 80 80
CaveScheduling=bd2ckatari
PALTiming=true
FrameTime=160 160 160 160 160
CaveDelay=8 8 8 8 8
TimeValue=1 1 1 1 1
DiamondValue=2 4
RandSeed=0 0 0 0 0
ActiveGuyIsFirst=false
AmoebaProperties.immediately=false
MagicWallTime=0 0 0 0 0
MagicWallProperties.convertamoeba=false
SlimePermeabilityC64=0 0 0 0 0
BorderProperties.lineshift=true
BorderProperties.objectwraparound=true
BorderProperties.scan=false

[map]
WWWWWWWWWWWWWWWWWWWWWWWWWWWWWWWWWWWWWWWW
W...Q... ... ..r. .. .. .r. .r. ....r .W
W... .r. ... .... .. .. ... ... ....w .W
W... ... .r. .r.. .. .. ... ... ....w .W
W... ... ... .... .. .. ... ... ....w..W
W... ...Q... .... .. .. ... ... .r..w..W
W... ... ... ..r. .. .. ... ... .r..w..W
W... ... ... .... .. .. ... ... .r..w..W
W... .r. ... .... .. .. .r. .r. .r..w..W
W... ... ...Q.... .. .. ... ... ....w..W
W... ... .r. .... .. .. ... .r. ....w..W
WP.. ... ... .r..Q.. .. ... ... wwwww..W
W... .r. ... .... .. .. ... ... wddddddW
W... ... ... .... .. .. .r. ...QwddddddW
W... ... ... ..r. .. .. ... .r. wddddddW
W... ... ... .... ..Q.. ... ... wddddddW
W... ... .r. .... .. .. .r. ... wddddddW
W... ... ... .r.. .. .. ... ... wddddddW
W... .r. ... .... .. ..Q... ... wddddddW
W... ... ... .... .. .. ... ... wddddddW
W... ... ... .... .. .. ...Q... wdddddXW
WWWWWWWWWWWWWWWWWWWWWWWWWWWWWWWWWWWWWWWW
[/map]
[/cave]

[cave]
Name=Intermission 05
IntermissionProperties.instantlife=true
Intermission=true
IntermissionProperties.rewardlife=false
Size=40 22 0 0 19 11
Colors=Atari00 Atari00 Atari34 Atari7c Atari0f Atari0f Atari0f
DiamondsRequired=50 50 50 50 50
CaveTime=50 50 50 50 50
CaveScheduling=bd2ckatari
PALTiming=true
FrameTime=140 140 140 140 140
CaveDelay=7 7 7 7 7
TimeValue=1 1 1 1 1
DiamondValue=7 10
RandSeed=0 0 0 0 0
ActiveGuyIsFirst=false
AmoebaProperties.immediately=false
MagicWallTime=0 0 0 0 0
MagicWallProperties.convertamoeba=false
SlimePermeabilityC64=0 0 0 0 0
BorderProperties.lineshift=true
BorderProperties.objectwraparound=true
BorderProperties.scan=false

[map]
WWWWWWWWWWWWWWWWWWWWWWWWWWWWWWWWWWWWWWWW
W.rw...dddddd..r w.WWWWWWWWWWWWWWWWWWWWW
W..w..drrddrrd.. w.WWWWWWWWWWWWWWWWWWWWW
W..w.ddrrddrrdd. w.WWWWWWWWWWWWWWWWWWWWW
W..w.dddddddddd. w.WWWWWWWWWWWWWWWWWWWWW
W..w..ddrddrrd.. w.WWWWWWWWWWWWWWWWWWWWW
W..w...ddrrdd... w.WWWWWWWWWWWWWWWWWWWWW
W..w...ddddd.... w.WWWWWWWWWWWWWWWWWWWWW
W..w.dddddddddd.cwXWWWWWWWWWWWWWWWWWWWWW
W..wwwwwwwwwwwwwwwwWWWWWWWWWWWWWWWWWWWWW
W.......P.c        WWWWWWWWWWWWWWWWWWWWW
WWWWWWWWWWWWWWWWWWWWWWWWWWWWWWWWWWWWWWWW
WWWWWWWWWWWWWWWWWWWWWWWWWWWWWWWWWWWWWWWW
WWWWWWWWWWWWWWWWWWWWWWWWWWWWWWWWWWWWWWWW
WWWWWWWWWWWWWWWWWWWWWWWWWWWWWWWWWWWWWWWW
WWWWWWWWWWWWWWWWWWWWWWWWWWWWWWWWWWWWWWWW
WWWWWWWWWWWWWWWWWWWWWWWWWWWWWWWWWWWWWWWW
WWWWWWWWWWWWWWWWWWWWWWWWWWWWWWWWWWWWWWWW
WWWWWWWWWWWWWWWWWWWWWWWWWWWWWWWWWWWWWWWW
WWWWWWWWWWWWWWWWWWWWWWWWWWWWWWWWWWWWWWWW
WWWWWWWWWWWWWWWWWWWWWWWWWWWWWWWWWWWWWWWW
WWWWWWWWWWWWWWWWWWWWWWWWWWWWWWWWWWWWWWWW
[/map]
[/cave]

[cave]
Name=Cave 06
IntermissionProperties.instantlife=true
Intermission=false
IntermissionProperties.rewardlife=false
Size=40 22 0 0 39 21
Colors=Atari00 Atari00 Atari04 Ataric6 Atari0f Atari0f Atari0f
DiamondsRequired=45 45 45 45 45
CaveTime=80 80 80 80 80
CaveScheduling=bd2ckatari
PALTiming=true
FrameTime=140 140 140 140 140
CaveDelay=7 7 7 7 7
TimeValue=1 1 1 1 1
DiamondValue=2 3
RandSeed=0 0 0 0 0
ActiveGuyIsFirst=false
AmoebaProperties.immediately=false
MagicWallTime=0 0 0 0 0
MagicWallProperties.convertamoeba=false
SlimePermeabilityC64=0 0 0 0 0
BorderProperties.lineshift=true
BorderProperties.objectwraparound=true
BorderProperties.scan=false

[map]
WWWWWWWWWWWWWWWWWWWWWWWWWWWWWWWWWWWWWWWW
WP.......d.d...........................W
W......r.........r.r......r.........r..W
W..........d.......Q.........d.........W
W..wwww.wwww.wwww..d..wwww.wwww.wwww...W
W..w    wdd..w    .d..w d  wdd..w    ..W
W..w Q  wd...wQ   .d..wQ   wd..dwQ   ..W
W..wwww wd...wwww  dd.wwww wd...wwww ..W
W.d...wdw ....d.w .d.....wdwd......wd..W
W.....w.wdd...d.w..d.....wdwdd.....wd..W
W..wwwwrwwww.wwwwr.d..wwww wwww.wwww. .W
W.d..d..d.d.d......d...................W
W..wwww.wwww.wwww. d..wwww.wwww.wwww.d.W
W..w    w....w    .d.dw    wdd..w d  d.W
W.dwQ   w.d..wQ   .d..wQ   w ...wQ   d.W
Wd.wwww w.dd.wwxw .d..wwww wd...wxww d.W
W.....wdw.dd..d.wd d.....w wd...  dw d.W
W.....w.w..d....w..d.....w wdd..  .w d.W
W..wwww.wwww.wwww.....wwwwdwwww.wwww.d.W
W.d...d..d..d...d......d.d...........d.W
W....d....d......................Qd...XW
WWWWWWWWWWWWWWWWWWWWWWWWWWWWWWWWWWWWWWWW
[/map]
[/cave]

[cave]
Name=Cave 07
IntermissionProperties.instantlife=true
Intermission=false
IntermissionProperties.rewardlife=false
Size=40 22 0 0 39 21
Colors=Atari00 Atari00 Atari12 Atarif4 Atari0f Atari0f Atari0f
DiamondsRequired=99 99 99 99 99
CaveTime=180 180 180 180 180
CaveScheduling=bd2ckatari
PALTiming=true
FrameTime=120 120 120 120 120
CaveDelay=6 6 6 6 6
TimeValue=1 1 1 1 1
DiamondValue=2 2
RandSeed=0 0 0 0 0
ActiveGuyIsFirst=false
AmoebaProperties.immediately=false
MagicWallTime=0 0 0 0 0
MagicWallProperties.convertamoeba=false
SlimePermeabilityC64=0 0 0 0 0
BorderProperties.lineshift=true
BorderProperties.objectwraparound=true
BorderProperties.scan=false

[map]
WWWWWWWWWWWWWWWWWWWWWWWWWWWWWWWWWWWWWWWW
Wr...d.d.wd.....w.ddd..d.dww....ddrd..rW
W.d..r....w.d.d......wd.......d..X...wQW
WQ..d......Q....d..d..dw.d....r..wdd.w.W
W.d........ww.dd.........d.......d....dW
WQQdd.r....d.rd..wdddd..d....r.........W
W......rd...r......d.Q....d.....Q......W
W........d.d.dd...d...d.r....d....Q....W
Wd..........dQd.....d.wd.w..ddr....d...W
W.........d......wdQ..d.w..r.d.dQd..d..W
W.d.rr.d........d.......d..d.QQ.......dW
Wr..Q...dd..d...ddr..dd.d...Q..........W
W.d.ww..r.....d.d.d..w.dd......Q......QW
W....d.w..dr.d.......Qd..d..........dd.W
Wrr.....d.Q..P...w...........d.d....dr.W
Wd...d..dw.QQ...dw.d..d..w....dw...rQ..W
W.....Q..w.Q...........d..wrd.....wr...W
W..d.d.......rw..d......Qw.d.w......r.wW
W.d....d...d.d.Q.d.d.......d.....d.d...W
W...d.wrw.d.Q....d...Q..r.Q.QQd...d....W
W....r....r..d.d...r.d.w..d.......d.r..W
WWWWWWWWWWWWWWWWWWWWWWWWWWWWWWWWWWWWWWWW
[/map]
[/cave]

[cave]
Name=Cave 08
IntermissionProperties.instantlife=true
Intermission=false
IntermissionProperties.rewardlife=false
Size=40 22 0 0 39 21
Colors=Atari00 Atari00 Atari38 Atari7c Atari0f Atari0f Atari0f
DiamondsRequired=80 80 80 80 80
CaveTime=55 55 55 55 55
CaveScheduling=bd2ckatari
PALTiming=true
FrameTime=120 120 120 120 120
CaveDelay=6 6 6 6 6
TimeValue=1 1 1 1 1
DiamondValue=2 2
RandSeed=0 0 0 0 0
ActiveGuyIsFirst=false
AmoebaProperties.immediately=false
MagicWallTime=0 0 0 0 0
MagicWallProperties.convertamoeba=false
SlimePermeabilityC64=0 0 0 0 0
BorderProperties.lineshift=true
BorderProperties.objectwraparound=true
BorderProperties.scan=false

[map]
WWWWWWWWWWWWWWWWWWWWWWWWWWWWWWWWWWWWWWWW
WFFFFFWWWWWWWWWWWWFFFFFwwwwwwwwwwwwwwXPW
WFFFWWddddddddddddWWFFFwwwwwwwwwwwwww..W
WFWWWddddddddddddddWWWFwwww...wddwFFw..W
WFFFFWddddddddddddWFFFFwwww.w.wddwFFw..W
WFFFWddddddddddddddWFFFwwww.w.wddwFFw..W
Wwww................wwwQr.w.w.wddwFFw..W
Ww..wwwww......wwwww..w ..w.w.wddwFFw..W
Ww..w...w......w...w..w ..w.w.wddwFFw..W
Ww..wwwww......wwwww..w ..w.w.w..wFFw..W
Ww.....r ...... r.....w ..w.w.w..wFFw..W
Ww...... ..ww.. ......w ..w.w.w..wFFw..W
Ww...... ..ww.. ......w ..w.w.w..wFFw..W
Ww......Q..ww..Q......w ..w.w.w..wFFw..W
Ww....wwww....wwww....w ..w.w.w..wFFw..W
Ww....wwddwwwwddww....w ..w.w.w..wFFw..W
Ww.....wwddddddww.....w ..w.w.w..wFFw..W
Ww.....wwddddddww.....w ..w.w.w..wFFw..W
Ww.......wwwwww.......w ..w.w.w..wFFw..W
Ww....................w ..w.w.w..wwww..W
Wwwwwwwwwwwwwwwwwwwwwww ....w..........W
WWWWWWWWWWWWWWWWWWWWWWWWWWWWWWWWWWWWWWWW
[/map]
[/cave]

[cave]
Name=Cave 09
IntermissionProperties.instantlife=true
Intermission=false
IntermissionProperties.rewardlife=false
Size=40 22 0 0 39 21
Colors=Atari00 Atari00 Atari12 Atari42 Atari0f Atari0f Atari0f
DiamondsRequired=90 90 90 90 90
CaveTime=150 150 150 150 150
CaveScheduling=bd2ckatari
PALTiming=true
FrameTime=140 140 140 140 140
CaveDelay=7 7 7 7 7
TimeValue=1 1 1 1 1
DiamondValue=5 5
RandSeed=0 0 0 0 0
ActiveGuyIsFirst=false
AmoebaProperties.immediately=false
MagicWallTime=0 0 0 0 0
MagicWallProperties.convertamoeba=false
SlimePermeabilityC64=0 0 0 0 0
BorderProperties.lineshift=true
BorderProperties.objectwraparound=true
BorderProperties.scan=false

[map]
WWWWWWWWWWWWWWWWWWWWWWWWWWWWWWWWWWWWWWWW
W............d................d.....d..W
W.......w...r...d.....d.w.d.d...d.d....W
W...dd...d.dr.rw........w..w...w...drw.W
W..rd.......r.d........w..w...wdw..dr.dW
W..d......X..d.r......wFww...w.dw..drw.W
W......................w..wQ.w..dd.dr..W
W...wQQQ.QQQ.QQQ...d....w..w..www..drw.W
W.d..Q...Q...Q...d...d..w..........dr..W
Wd.w.QQQ.Q...QQQ.d....Qw..d.......rrrwdW
W.w.w..Q.Q.....Q....d.w.....w.rww..d.d.W
W.dw.QQQ.QQQ.QQQ..d..w.rdd..........w..W
W.d.............w......Q....drd..w...d.W
W..d.d.d...d.w...d.d...d..dQ.dQ..Q..Q.rW
W.d.r...ddd..........d.wd....d.....d...W
Wr.d.w.d.d.....wd...Q..........d....dr.W
W.Q...d.d..P..d...d.....d........d....QW
W...r...wd.r.d......r..w.dr.Q.....d...rW
W.d.d........rd.d....d..d...r..ddr.d...W
Wrr....ddd.d...d..d..r.d.d..d...wQ..Q..W
W.d..dr.......d...w.d.d.Q.r...d......d.W
WWWWWWWWWWWWWWWWWWWWWWWWWWWWWWWWWWWWWWWW
[/map]
[/cave]

[cave]
Name=Intermission 10
IntermissionProperties.instantlife=true
Intermission=true
IntermissionProperties.rewardlife=false
Size=40 22 0 0 19 11
Colors=Atari00 Atari00 Atari12 Atari12 Atari0f Atari0f Atari0f
DiamondsRequired=25 25 25 25 25
CaveTime=50 50 50 50 50
CaveScheduling=bd2ckatari
PALTiming=true
FrameTime=120 120 120 120 120
CaveDelay=6 6 6 6 6
TimeValue=1 1 1 1 1
DiamondValue=72 72
RandSeed=0 0 0 0 0
ActiveGuyIsFirst=false
AmoebaProperties.immediately=false
MagicWallTime=0 0 0 0 0
MagicWallProperties.convertamoeba=false
SlimePermeabilityC64=0 0 0 0 0
BorderProperties.lineshift=true
BorderProperties.objectwraparound=true
BorderProperties.scan=false

[map]
WWWWWWWWWWWWWWWWWWWWWWWWWWWWWWWWWWWWWWWW
W..rrrrrrrrrrrr....WWWWWWWWWWWWWWWWWWWWW
W..rrrrrrrrrrrrr..PWWWWWWWWWWWWWWWWWWWWW
W..................WWWWWWWWWWWWWWWWWWWWW
WXMMMMMMMMMMMMMM...WWWWWWWWWWWWWWWWWWWWW
W.              ...WWWWWWWWWWWWWWWWWWWWW
W. ccc ccc ccc  ...WWWWWWWWWWWWWWWWWWWWW
W. ccc ccc ccc  ...WWWWWWWWWWWWWWWWWWWWW
W.              ...WWWWWWWWWWWWWWWWWWWWW
W. ccc ccc cccc ...WWWWWWWWWWWWWWWWWWWWW
W. ccc ccc cccc ...WWWWWWWWWWWWWWWWWWWWW
WWWWWWWWWWWWWWWWWWWWWWWWWWWWWWWWWWWWWWWW
WWWWWWWWWWWWWWWWWWWWWWWWWWWWWWWWWWWWWWWW
WWWWWWWWWWWWWWWWWWWWWWWWWWWWWWWWWWWWWWWW
WWWWWWWWWWWWWWWWWWWWWWWWWWWWWWWWWWWWWWWW
WWWWWWWWWWWWWWWWWWWWWWWWWWWWWWWWWWWWWWWW
WWWWWWWWWWWWWWWWWWWWWWWWWWWWWWWWWWWWWWWW
WWWWWWWWWWWWWWWWWWWWWWWWWWWWWWWWWWWWWWWW
WWWWWWWWWWWWWWWWWWWWWWWWWWWWWWWWWWWWWWWW
WWWWWWWWWWWWWWWWWWWWWWWWWWWWWWWWWWWWWWWW
WWWWWWWWWWWWWWWWWWWWWWWWWWWWWWWWWWWWWWWW
WWWWWWWWWWWWWWWWWWWWWWWWWWWWWWWWWWWWWWWW
[/map]
[/cave]

[cave]
Name=Cave 11
IntermissionProperties.instantlife=true
Intermission=false
IntermissionProperties.rewardlife=false
Size=40 22 0 0 39 21
Colors=Atari00 Atari00 Atari7c Ataric6 Atari0f Atari0f Atari0f
DiamondsRequired=80 80 80 80 80
CaveTime=136 136 136 136 136
CaveScheduling=bd2ckatari
PALTiming=true
FrameTime=140 140 140 140 140
CaveDelay=7 7 7 7 7
TimeValue=1 1 1 1 1
DiamondValue=3 3
RandSeed=0 0 0 0 0
ActiveGuyIsFirst=false
AmoebaProperties.immediately=false
MagicWallTime=0 0 0 0 0
MagicWallProperties.convertamoeba=false
SlimePermeabilityC64=0 0 0 0 0
BorderProperties.lineshift=true
BorderProperties.objectwraparound=true
BorderProperties.scan=false

[map]
WWWWWWWWWWWWWWWWWWWWWWWWWWWWWWWWWWWWWWWW
WP................. .... .... .... .XddW
W.................. ....r....r....r..ddW
Wxddx..xddx..xddx.. .................ddW
W....dd....dd....d.Q....M....M....M..ddW
Wddx..xddx..xddx...r.... .... .... ..ddW
W...dd....dd....dd...... .... .... ..ddW
Wxddx..xddx..xddx.. .... .... .... ..ddW
W....dd....dd....d. .... .... .... ..ddW
W..x..x..x..x..x... .... .... .... ..ddW
W.dd...dd.....dd... .... .... .... ..ddW
Wx..x..x..x..x..x..M....Q....Q....Q...dW
W.................. ....r....r....r....W
W.wr..w.rw..w.rw... ...................W
W..c..d.c.d.c.d....Q....M.... .... ....W
W.d.wr.w..w..wr.w.. .... .... .... ....W
W.......r.....d....r.... .... .... ....W
Wwcr..wddw..wr.w.r.M.... .... .... ....W
W..d..c..r...d.r.d. .... .... .... ....W
W.r.w.rw..w..w.cw.. .... .... .... ....W
W..................Q....c....c....c....W
WWWWWWWWWWWWWWWWWWWWWWWWWWWWWWWWWWWWWWWW
[/map]
[/cave]

[cave]
Name=Cave 12
IntermissionProperties.instantlife=true
Intermission=false
IntermissionProperties.rewardlife=false
Size=40 22 0 0 39 21
Colors=Atari00 Atari00 Atari38 Atari42 Atari0f Atari0f Atari0f
DiamondsRequired=70 70 70 70 70
CaveTime=150 150 150 150 150
CaveScheduling=bd2ckatari
PALTiming=true
FrameTime=140 140 140 140 140
CaveDelay=7 7 7 7 7
TimeValue=1 1 1 1 1
DiamondValue=10 11
RandSeed=0 0 0 0 0
ActiveGuyIsFirst=false
AmoebaProperties.immediately=false
MagicWallTime=0 0 0 0 0
MagicWallProperties.convertamoeba=false
SlimePermeabilityC64=0 0 0 0 0
BorderProperties.lineshift=true
BorderProperties.objectwraparound=true
BorderProperties.scan=false

[map]
WWWWWWWWWWWWWWWWWWWWWWWWWWWWWWWWWWWWWWWW
W...rd..Q .....d.dwdw....w...wdw.d.d...W
Ww......w .wd.Qwdw...d......d...w..d.d.W
W..dw.....r..ww..Qw.w..w..w..r.r..wd...W
W.dwd.....w....d.w wd...d.w.d.dw.....w.W
Wd.w..Q..d.....r..wdr.....d........w..wW
W.ww.w.ww.d.....wwd....wrddwwd.d.wr.d.wW
WP.w....d....w.......w...........w.w..wW
Wwrrr.w.wwd.w...w.. ....w..d.d..r.w..w.W
W...w...r.d....d..d.w..d.w.w.dw..w.w...W
Wd..d.r...w...Q...ww...rw....w...w.....W
W .......d..rww..d.d.r.ww..ww...QrQ...rW
W.Qd..w.w..d.w.rw.wd.rddddd..w...ww..d.W
W.d.w.w..w..w..Qw.w.wd.d.d.....dwd.....W
Ww..w.r.d.wd.w...d.w....w.wd.d.r.w.w...W
W...dr...Q...wdw...Qw....w.....wr......W
W.....w w.w......dww....d.w.w..........W
W..w..Qww.wdd.wd.........w..w....d.w...W
WQ.dww..dd..d.dwd....wd...ww......ww.wwW
W..w......d..wXw.....w..w..w..r.ww..w.wW
Wd.ww.r......rw....w....d.d......d....dW
WWWWWWWWWWWWWWWWWWWWWWWWWWWWWWWWWWWWWWWW
[/map]
[/cave]

[cave]
Name=Cave 13
IntermissionProperties.instantlife=true
Intermission=false
IntermissionProperties.rewardlife=false
Size=40 22 0 0 39 21
Colors=Atari00 Atari00 Atari42 Atarif4 Atari0f Atari0f Atari0f
DiamondsRequired=90 90 90 90 90
CaveTime=180 180 180 180 180
CaveScheduling=bd2ckatari
PALTiming=true
FrameTime=140 140 140 140 140
CaveDelay=7 7 7 7 7
TimeValue=1 1 1 1 1
DiamondValue=2 18
RandSeed=0 0 0 0 0
ActiveGuyIsFirst=false
AmoebaProperties.immediately=false
MagicWallTime=0 0 0 0 0
MagicWallProperties.convertamoeba=false
SlimePermeabilityC64=0 0 0 0 0
BorderProperties.lineshift=true
BorderProperties.objectwraparound=true
BorderProperties.scan=false

[map]
WWWWWWWWWWWWWWWWWWWWWWWWWWWWWWWWWWWWWWWW
Ww.....w.w.d...d....r.w.rrrd..drrdww...W
W..d..d.d...w.w.w.......d...d....d...d.W
W.r..w.w.F.d.w.d....d..ww.........r....W
W...wr..r.w.w.rrr................r.d.w.W
W.r..dw..d...w.d..FFFXFFF.FFF..dr......W
W.w.d.....d..d....F...F...F.....dw.....W
W....r.w...w.d.wdrFFF.F...FFF.dd.......W
W....r....w...Fddr..F.F.....F.drr.r.d..W
Ww.w.r.r.w....w.d.FFFPFFF.FFF..w..w....W
Ww..d..d.drr.rr..r.............dw..w...W
WFdw...ddr...rd..dr..wwdddd...dr..d....W
W.w.d...dr.....d..d...w.....d....d.....W
Wr..rw.w...w.r.rd.r..d..dr.r...rd..w..wW
W...d..dw.wd.r.r.....rd.w...wF..dddd...W
Wd.wddww...r.d.d.dww.....wd....r.rr.w..W
W.w.r.w.w..d..d....d.dw..........d.....W
W.....rr..rr..rr.d.r.r.d.wd.r..dd...F.wW
W...r.d..www.d...r.drdr...d.d.w.dF.w..dW
W..wd..w...w...d.....drd..d....w....d.dW
W....d...d.d..w.......d...d......d.r.ddW
WWWWWWWWWWWWWWWWWWWWWWWWWWWWWWWWWWWWWWWW
[/map]
[/cave]

[cave]
Name=Cave 14
IntermissionProperties.instantlife=true
Intermission=false
IntermissionProperties.rewardlife=false
Size=40 22 0 0 39 21
Colors=Atari00 Atari00 Atari34 Atari38 Atari0f Atari0f Atari0f
DiamondsRequired=99 99 99 99 99
CaveTime=135 135 135 135 135
CaveScheduling=bd2ckatari
PALTiming=true
FrameTime=140 140 140 140 140
CaveDelay=7 7 7 7 7
TimeValue=1 1 1 1 1
DiamondValue=6 7
RandSeed=0 0 0 0 0
ActiveGuyIsFirst=false
AmoebaProperties.immediately=false
MagicWallTime=0 0 0 0 0
MagicWallProperties.convertamoeba=false
SlimePermeabilityC64=0 0 0 0 0
BorderProperties.lineshift=true
BorderProperties.objectwraparound=true
BorderProperties.scan=false

[map]
WWWWWWWWWWWWWWWWWWWWWWWWWWWWWWWWWWWWWWWW
Wd....r....Fd.....rdd.....wd..d...Fw.d.W
W...d....dd.ddw..d.dd....d..d.....d..d.W
W..dd....d...rw........dF.........cdc..W
W....c..d..r...dr.....cr..dc.....r.d.d.W
W..d.d....dFd....dw..F..d......d.d.c...W
W....Frwww.www.www.dddw....d..c.d..rd.dW
Wd.d.d.w..Fw.d.w.dd..dr.....r...F.....dW
Wd...c.www.wX.dwww...dddd.......d.....dW
Wd...ddr.w.w.....w..crF.d..d...rddd....W
W.d...rwww.wwwdwww..r..r.d..ddF.d.d..r.W
W.r.c.dd..........F.d.d.d...rd..cdF.d..W
Wd.....dd.d...........d.wd...d.....dd.dW
W..r....d......d..drd.rr.ddrd...r......W
W.d....w.d....w.r..d....dd............dW
W.....d.d...dw.....rd.dd.....d.r....d.dW
W.Fd.dd...........F..dr.rr......d....d.W
Wdd....d...Fd...d..d..d.dd.d.......d.rdW
W.........rrFd.d..............d.......dW
W..c.d.d.d......d.....r.r.dr....c...dd.W
Wr......d...d..dd.........d..P.....rd..W
WWWWWWWWWWWWWWWWWWWWWWWWWWWWWWWWWWWWWWWW
[/map]
[/cave]

[cave]
Name=Intermission 15
IntermissionProperties.instantlife=true
Intermission=true
IntermissionProperties.rewardlife=false
Size=40 22 0 0 19 11
Colors=Atari00 Atari00 Atari12 Atari42 Atari0f Atari0f Atari0f
DiamondsRequired=35 35 35 35 35
CaveTime=40 40 40 40 40
CaveScheduling=bd2ckatari
PALTiming=true
FrameTime=120 120 120 120 120
CaveDelay=6 6 6 6 6
TimeValue=1 1 1 1 1
DiamondValue=99 99
RandSeed=0 0 0 0 0
ActiveGuyIsFirst=false
AmoebaProperties.immediately=false
MagicWallTime=0 0 0 0 0
MagicWallProperties.convertamoeba=false
SlimePermeabilityC64=0 0 0 0 0
BorderProperties.lineshift=true
BorderProperties.objectwraparound=true
BorderProperties.scan=false

[map]
WWWWWWWWWWWWWWWWWWWWWWWWWWWWWWWWWWWWWWWW
W..................WWWWWWWWWWWWWWWWWWWWW
W.ddd..d...d..ddd..WWWWWWWWWWWWWWWWWWWWW
W.d....dd..d..d..d.WWWWWWWWWWWWWWWWWWWWW
W.dd...d.d.d..d..d.WWWWWWWWWWWWWWWWWWWWW
W.d....d..dd..d..d.WWWWWWWWWWWWWWWWWWWWW
WXddd..d...d..ddd..WWWWWWWWWWWWWWWWWWWWW
Wwwwwwwwwwwwwwwwww.WWWWWWWWWWWWWWWWWWWWW
W .Pr w............WWWWWWWWWWWWWWWWWWWWW
W ... w............WWWWWWWWWWWWWWWWWWWWW
W    Qw............WWWWWWWWWWWWWWWWWWWWW
WWWWWWWWWWWWWWWWWWWWWWWWWWWWWWWWWWWWWWWW
WWWWWWWWWWWWWWWWWWWWWWWWWWWWWWWWWWWWWWWW
WWWWWWWWWWWWWWWWWWWWWWWWWWWWWWWWWWWWWWWW
WWWWWWWWWWWWWWWWWWWWWWWWWWWWWWWWWWWWWWWW
WWWWWWWWWWWWWWWWWWWWWWWWWWWWWWWWWWWWWWWW
WWWWWWWWWWWWWWWWWWWWWWWWWWWWWWWWWWWWWWWW
WWWWWWWWWWWWWWWWWWWWWWWWWWWWWWWWWWWWWWWW
WWWWWWWWWWWWWWWWWWWWWWWWWWWWWWWWWWWWWWWW
WWWWWWWWWWWWWWWWWWWWWWWWWWWWWWWWWWWWWWWW
WWWWWWWWWWWWWWWWWWWWWWWWWWWWWWWWWWWWWWWW
WWWWWWWWWWWWWWWWWWWWWWWWWWWWWWWWWWWWWWWW
[/map]
[/cave]
[/game]
[/BDCFF]
